,Date,Address,New_price,Old_price,Change(€),Change(%),Page,County,Province
0,2022-11-26," 5 Woodbrook Hall, Carpenterstown, Dublin 15 ",295000,275000,20000,7.27,1,Dublin 15,Leinster
1,2022-11-25," 18 The Crescent, Cnoc na Greine, Kilcullen, Kildare ",379950,369950,10000,2.7,1,Kildare,Leinster
2,2022-11-25," 9 Hawthorn House, Carrickmines Green, Carrickmines, Dublin 18 ",430000,399950,30050,7.51,1,Dublin 18,Leinster
3,2022-11-25," Ballybricken, Grange, Limerick ",99000,100000,-1000,-1.0,1,Limerick,Munster
4,2022-11-25," 5 Woodstown Rise, Knocklyon, Dublin 16 ",505000,530000,-25000,-4.72,1,Dublin 16,Leinster
5,2022-11-25," Weatherfort,Clogher, Claremorris, Mayo ",55000,65000,-10000,-15.38,1,Mayo,Connaught
6,2022-11-25," 23 Oakwood, Old Singland Road, Limerick City ",300000,275000,25000,9.09,1,Limerick,Munster
7,2022-11-25," 15 Melvin Road, Terenure, Dublin 6W ",395000,445000,-50000,-11.24,1,Dublin,Leinster
8,2022-11-25," 21 Canal Court, Whitefields, Portarlington, Co. Laois ",215000,225000,-10000,-4.44,1,Laois,Leinster
9,2022-11-25," High Street, Bantry, Co. Cork ",175000,200000,-25000,-12.5,1,Cork,Munster
10,2022-11-25," Ballinaclogh, Rosscarbery,   Cork West ",160000,150000,10000,6.67,1,Cork,Munster
11,2022-11-25," Apt. 53 Harbour Court, George's Place, , Dun Laoghaire, Dublin ",515000,560000,-45000,-8.04,1,Dublin,Leinster
12,2022-11-25," The Forge, Tenure, Dunleer, Louth ",750000,800000,-50000,-6.25,1,Louth,Leinster
13,2022-11-24," 76 Brandon Road, Drimnagh, Dublin 12 ",319950,349950,-30000,-8.57,2,Dublin 12,Leinster
14,2022-11-24," 22 The Fairway, The Old Course, Mallow, Co. Cork ",220000,230000,-10000,-4.35,2,Cork,Munster
15,2022-11-24," 58 Hazel Brooke, Spa Glen, Mallow, Co. Cork ",220000,225000,-5000,-2.22,2,Cork,Munster
16,2022-11-24," 28 Aylesbury Avenue, Aylesbury, Ferrybank, Co. Waterford ",325000,350000,-25000,-7.14,2,Waterford,Munster
17,2022-11-24," 42 Turret Road, Palmerstown, Palmerstown, Dublin 20, Palmerstown, Dublin 20 ",350000,425000,-75000,-17.65,2,Dublin 20,Leinster
18,2022-11-24," 20 Fairway Drive, Cualanor, Dun Laoghaire, Dublin ",975000,1000000,-25000,-2.5,2,Dublin,Leinster
19,2022-11-24," 2 Woodbine Avenue , Booterstown, County Dublin ",645000,695000,-50000,-7.19,2,Dublin,Leinster
20,2022-11-24," 9 Double Lane, Maynooth, Co. Kildare ",315000,325000,-10000,-3.08,2,Kildare,Leinster
21,2022-11-24," 17 Scelig Ard, Headford Road, Galway ",330000,340000,-10000,-2.94,2,Galway,Connaught
22,2022-11-24," Patriciain Park, Castlebar, Mayo ",235000,255000,-20000,-7.84,2,Mayo,Connaught
23,2022-11-24," 2 Riverwalk Cottage, Drumcliff, Sligo ",295000,250000,45000,18.0,2,Sligo,Connaught
24,2022-11-24," 29 Harcourt Green, Charlemont Street, Dublin 2, South City Centre, Dublin 2 ",495000,525000,-30000,-5.71,2,Dublin 2,Leinster
25,2022-11-24," St. Patrick's, Drombanna, Limerick ",455000,490000,-35000,-7.14,2,Limerick,Munster
26,2022-11-24,"  Wilton, Bree, Co. Wexford, Bree, Wexford ",430000,450000,-20000,-4.44,2,Wexford,Leinster
27,2022-11-24," Ballymore Lodge, Valley Road, Ballymore, Cobh, County Cork, Cobh, Cork ",1350000,1750000,-400000,-22.86,2,Cork,Munster
28,2022-11-24," 223 Viewmount Park, Waterford City, Waterford ",339000,349000,-10000,-2.87,3,Waterford,Munster
29,2022-11-24," Clonmore, Mullingar, Westmeath ",285000,275000,10000,3.64,3,Westmeath,Leinster
30,2022-11-24," 27 The Maltings, Bray, Wicklow ",345000,365000,-20000,-5.48,3,Wicklow,Leinster
31,2022-11-24," 2 FLEMINGS COURT TALLOW STREET YOUGHAL, Youghal, Cork ",75000,80000,-5000,-6.25,3,Cork,Munster
32,2022-11-24," 3 The Walk, Fairfield Park, Waterford City, Waterford ",209000,215000,-6000,-2.79,3,Waterford,Munster
33,2022-11-24," 19 Buttery Court, Market Square, Mallow, Cork ",140000,110000,30000,27.27,3,Cork,Munster
34,2022-11-24," 8 Shanabooly Avenue, Ballynanty, Limerick City ",75000,87500,-12500,-14.29,3,Limerick,Munster
35,2022-11-24," Ardbawn, Thurles, Tipperary ",650000,620000,30000,4.84,3,Tipperary,Munster
36,2022-11-23," Kilcannon, Cappagh, Dungarvan, Co. Waterford ",320000,310000,10000,3.23,3,Waterford,Munster
37,2022-11-23," Site with FPP at Chapel Avenue, Irishtown, Dublin 4 ",450000,495000,-45000,-9.09,3,Dublin 4,Leinster
38,2022-11-23," 33 Bremore Pastures Way, Balbriggan, Dublin ",205000,215000,-10000,-4.65,3,Dublin,Leinster
39,2022-11-23," 46 Villa Park Road, Navan Road, Dublin 7 ",640000,675000,-35000,-5.19,3,Dublin 7,Leinster
40,2022-11-23," 223 Ballyroan Road, Rathfarnham, Dublin 16 ",660000,695000,-35000,-5.04,3,Dublin 16,Leinster
41,2022-11-23," Rosdaul, Williamstown, Galway ",160000,150000,10000,6.67,3,Galway,Connaught
42,2022-11-23," Two Bedroom Terrace Residence, 4 Woodleigh Park, Blessington, Wicklow ",285000,299000,-14000,-4.68,3,Wicklow,Leinster
43,2022-11-23," Skeagh, Aghaboe, Ballacolla, Co. Laois ",229000,240000,-11000,-4.58,3,Laois,Leinster
44,2022-11-23," Dromin Upper, Listowel, Kerry ",285000,300000,-15000,-5.0,3,Kerry,Munster
45,2022-11-23," 104 Cluain Bui, Green Road, Carlow Town, Carlow ",199500,210000,-10500,-5.0,3,Carlow,Leinster
46,2022-11-23," 805 Newtown House, Henry Street, Co. Limerick ",175000,150000,25000,16.67,4,Limerick,Munster
47,2022-11-23," 23 Mornington Towers, Mornington, Meath ",279000,295000,-16000,-5.42,4,Meath,Leinster
48,2022-11-23," 9 The Copse, Woodpark, Ballinteer, Dublin 16 ",370000,340000,30000,8.82,4,Dublin 16,Leinster
49,2022-11-23," 99 King's Court, Parnell Street, Parnell Square, Dublin 1 ",385000,315000,70000,22.22,4,Dublin 1,Leinster
50,2022-11-23," 2 Ballyowen,Wellingtonbridge,Co Wexford,Y35X E24 ",385000,400000,-15000,-3.75,4,Wexford,Leinster
51,2022-11-23," The Cedars Abberley , Killiney, County Dublin ",485000,495000,-10000,-2.02,4,Dublin,Leinster
52,2022-11-23," Moulavanig, Kealkill, Bantry, Co. Cork ",450000,430000,20000,4.65,4,Cork,Munster
53,2022-11-23," 1 Cyprus Avenue, Dooradoyle, Limerick ",355000,385000,-30000,-7.79,4,Limerick,Munster
54,2022-11-23," Apt 34 Blacklion Manor, Greystones, Wicklow ",280000,290000,-10000,-3.45,4,Wicklow,Leinster
55,2022-11-23," Ballybeg, Ferns, Gorey, Wexford ",385000,375000,10000,2.67,4,Wexford,Leinster
56,2022-11-22," 21 Northbrook Road, Ranelagh, Dublin 6 ",2495000,2750000,-255000,-9.27,4,Dublin 6,Leinster
57,2022-11-22," Brockagh, Ballinderry, Nenagh, Co. Tipperary ",215000,175000,40000,22.86,5,Tipperary,Munster
58,2022-11-22," 10 Marconi Crescent, Dun Laoghaire, Co. Dublin ",950000,974950,-24950,-2.56,5,Dublin,Leinster
59,2022-11-22,"  96 Ashefield, Mullingar, Westmeath ",209950,219950,-10000,-4.55,5,Westmeath,Leinster
60,2022-11-22," Cartron, Milltown, Galway ",220000,265000,-45000,-16.98,5,Galway,Connaught
61,2022-11-22," 8 Dolphin Avenue, off South Circular Road, South City Centre, Dublin 8 ",850000,910000,-60000,-6.59,5,Dublin 8,Leinster
62,2022-11-22," 26 St John's Well Way, Kilmainham, Dublin 8 ",330000,275000,55000,20.0,5,Dublin 8,Leinster
63,2022-11-22," 11 Wheatfield Court, Muff, Co. Donegal ",85000,100000,-15000,-15.0,5,Donegal,Ulster
64,2022-11-22," 24 Upper Bride Street, Wexford Town, Wexford ",145000,150000,-5000,-3.33,5,Wexford,Leinster
65,2022-11-22," 24 Latchford Park, Clonee, Dublin 15 ",375000,385000,-10000,-2.6,5,Dublin 15,Leinster
66,2022-11-22," 21 Northbrook Road, Dublin 6 ",2495000,2750000,-255000,-9.27,5,Dublin 6,Leinster
67,2022-11-22," Sunville, Drimoleague,   West Cork ",235000,275000,-40000,-14.55,5,Cork,Munster
68,2022-11-22," 48 Coill Clocha, Oranmore, Galway ",320000,335000,-15000,-4.48,5,Galway,Connaught
69,2022-11-22," Barrettstown, Knocktopher, Kilkenny ",595000,650000,-55000,-8.46,5,Kilkenny,Leinster
70,2022-11-22," 14 Retirement Village, Skibbereen,   West Cork ",135000,145000,-10000,-6.9,6,Cork,Munster
71,2022-11-22," 11 Clusker Park, Blackcastle, Navan, Co. Meath ",135000,150000,-15000,-10.0,6,Meath,Leinster
72,2022-11-22," 26 Gorey Hill, Gorey, Co. Wexford ",190000,200000,-10000,-5.0,6,Wexford,Leinster
73,2022-11-22," Clongowney, Old Dublin Road, ",494950,535000,-40050,-7.49,6,Dublin,Leinster
74,2022-11-22," 11 Clonee Court, Clonee, Dublin 15 ",215000,220000,-5000,-2.27,6,Dublin 15,Leinster
75,2022-11-21," 2 Cluan Enda, St. Alphonsus Road, Dundalk, Co. Louth ",175000,155000,20000,12.9,6,Louth,Leinster
76,2022-11-21," Treenlaur , Kiltimagh, Mayo ",290000,300000,-10000,-3.33,6,Mayo,Connaught
77,2022-11-21," View Halloa, Coast Road, Castletownsend, Cork ",350000,415000,-65000,-15.66,6,Cork,Munster
78,2022-11-21," Old House, Nedineagh, Dunmanway, West Cork ",170000,270000,-100000,-37.04,6,Cork,Munster
79,2022-11-21," Tonlagee, Corlough, Co Cavan H14 XP96 ",219000,199000,20000,10.05,6,Cavan,Ulster
80,2022-11-21," Innishannon, Cove Road, Tramore, Waterford ",750000,695000,55000,7.91,6,Waterford,Munster
81,2022-11-21," 1 Malt House, Mary Street, Co. Waterford ",130000,320000,-190000,-59.38,6,Waterford,Munster
82,2022-11-21," 18 Highfield, Lisnalea, Bailieborough, Cavan ",175000,189000,-14000,-7.41,6,Cavan,Ulster
83,2022-11-21," 13 Woodbank, Shankill, Dublin 18 ",725000,695000,30000,4.32,6,Dublin 18,Leinster
84,2022-11-21," 9 Amberley Lawn, Grange, Douglas, Cork ",295000,325000,-30000,-9.23,6,Cork,Munster
85,2022-11-21," 25 Grange Terrace, Blackrock, Deansgrange, Co. Dublin ",429950,419950,10000,2.38,7,Dublin,Leinster
86,2022-11-21," 5 Cedar Cottages, Blackrock, Co. Dublin ",550000,575000,-25000,-4.35,7,Dublin,Leinster
87,2022-11-21," 7 Foxcroft Avenue, Portarlington, Laois ",220000,235000,-15000,-6.38,7,Laois,Leinster
88,2022-11-21," Unit 3, Mark's Alley West, off Francis Street, South City Centre - D8, Dublin 8 ",300000,320000,-20000,-6.25,7,Dublin 8,Leinster
89,2022-11-21," 7 Main Street, Drimoleague,   West Cork ",180000,185000,-5000,-2.7,7,Cork,Munster
90,2022-11-21," Kentra, Ballydowling Hill, Rathdrum, Wicklow ",375000,325000,50000,15.38,7,Wicklow,Leinster
91,2022-11-21," 83 Ballisk Court, Donabate,   County Dublin ",345000,350000,-5000,-1.43,7,Dublin,Leinster
92,2022-11-21," 60 The Chase, Ramsgate Village, Gorey, Wexford ",240000,250000,-10000,-4.0,7,Wexford,Leinster
93,2022-11-21," 32 Chapelfield, Urlingford, Kilkenny ",165000,175000,-10000,-5.71,7,Kilkenny,Leinster
94,2022-11-21," 18 Bracken Lea, Letterkenny, Donegal ",250000,270000,-20000,-7.41,7,Donegal,Ulster
95,2022-11-21," 8 Churchfield Place East, City Centre Nth, Cork City ",197000,215000,-18000,-8.37,7,Cork,Munster
96,2022-11-20," 406 Grace Park Manor, Drumcondra, Dublin 9 ",360000,380000,-20000,-5.26,7,Dublin 9,Leinster
97,2022-11-19," 4 The Courtyard, St Raphaels Manor, Celbridge, Kildare ",295000,299000,-4000,-1.34,7,Kildare,Leinster
98,2022-11-19," Greenlawn + Site With FPP on 0.3 Acres, Church Lane, Greystones, Wicklow ",980000,1050000,-70000,-6.67,7,Wicklow,Leinster
99,2022-11-18," 12 The Court, High Park, Drumcondra, Dublin 3 ",355000,360000,-5000,-1.39,7,Dublin 3,Leinster
100,2022-11-18," Site @ Clongorey, Newbridge, Co. Kildare ",25000,30000,-5000,-16.67,7,Kildare,Leinster
101,2022-11-18," 80 Caltragh Heights, Sligo City, Sligo ",169000,179000,-10000,-5.59,7,Sligo,Connaught
102,2022-11-18," No. 2 Grattan Terrace, Gorey, Wexford ",265000,270000,-5000,-1.85,8,Wexford,Leinster
103,2022-11-18," 10 Langfield, Dublin Road, Dundalk, Louth ",200000,225000,-25000,-11.11,8,Louth,Leinster
104,2022-11-18," 61 Davis Court, Inchicore, Dublin 8 ",305000,275000,30000,10.91,8,Dublin 8,Leinster
105,2022-11-18," Lands at Ballyenahan, Kildorrey, Mitchelstown, Cork ",385000,480000,-95000,-19.79,8,Cork,Munster
106,2022-11-18," Old Court, Ballylynan, Laois ",265000,200000,65000,32.5,8,Laois,Leinster
107,2022-11-18," 5A The Crescent, Ennis, Clare ",250000,265000,-15000,-5.66,8,Clare,Munster
108,2022-11-18," Claremount House, Claremorris, Mayo ",200000,300000,-100000,-33.33,8,Mayo,Connaught
109,2022-11-18," 3 Golden Ridge Square, Rush,   County Dublin ",205000,220000,-15000,-6.82,8,Dublin,Leinster
110,2022-11-18," The Wicklow Escape, Donard, Wicklow ",750000,900000,-150000,-16.67,8,Wicklow,Leinster
112,2022-11-18," 1 Troys Green Green Street, Kilkenny, Kilkenny ",248000,285000,-37000,-12.98,8,Kilkenny,Leinster
113,2022-11-18," The Beeches Kill, Kilmacthomas, Waterford ",475000,495000,-20000,-4.04,8,Waterford,Munster
114,2022-11-17," Hilltop, Tyone, Nenagh, Co. Tipperary ",159950,189950,-30000,-15.79,8,Tipperary,Munster
115,2022-11-17," 5 Castlecurragh Heath, Mulhuddart, Dublin 15 ",310000,315000,-5000,-1.59,8,Dublin 15,Leinster
117,2022-11-17," 112 Carndonagh Park, Donaghmede, Dublin 13 ",385000,285000,100000,35.09,8,Dublin 13,Leinster
118,2022-11-17," 25 Mountain Drive, Ballymote, Co. Sligo ",145000,149000,-4000,-2.68,9,Sligo,Connaught
120,2022-11-17," Drumcask, Swanlinbar, Co. Cavan ",185000,195000,-10000,-5.13,9,Cavan,Ulster
121,2022-11-17," 14 Bothar Bui, Ballyconnell, Co. Cavan ",140000,150000,-10000,-6.67,9,Cavan,Ulster
122,2022-11-17," 28 Brentwood Crescent, Waterford City, Waterford ",275000,289000,-14000,-4.84,9,Waterford,Munster
123,2022-11-17," Back road, , Malahide, County Dublin ",550000,450000,100000,22.22,9,Dublin,Leinster
124,2022-11-17," 33 Brian Boru Ave, Clontarf, Dublin 3 ",399000,450000,-51000,-11.33,9,Dublin 3,Leinster
125,2022-11-17," 49 Boroimhe Birches, Swords, Dublin ",247000,265000,-18000,-6.79,9,Dublin,Leinster
127,2022-11-17," 4 Tara Glen Drive, Navan, Meath ",325000,355000,-30000,-8.45,9,Meath,Leinster
128,2022-11-17," 15 Deans Court, Blackrock, County Dublin ",575000,595000,-20000,-3.36,9,Dublin,Leinster
130,2022-11-17," Glenbride, Rathangan, Kildare ",360000,375000,-15000,-4.0,9,Kildare,Leinster
131,2022-11-17," Rathronshin, Ballybrittas, Laois ",250000,270000,-20000,-7.41,9,Laois,Leinster
132,2022-11-17," 84 Ardilaun Heights, Mullingar, Westmeath ",199000,225000,-26000,-11.56,9,Westmeath,Leinster
133,2022-11-17," 84 Hazelmere, Ballycane, Naas, Kildare ",275000,250000,25000,10.0,9,Kildare,Leinster
134,2022-11-17," 93 College Rise, Drogheda, Louth ",225000,250000,-25000,-10.0,9,Louth,Leinster
135,2022-11-17," 44 Shrewsbury Park, Ballsbridge, Dublin 4 ",945000,995000,-50000,-5.03,9,Dublin 4,Leinster
136,2022-11-17," 73, Block 5A, The Casino, Malahide, Dublin ",545000,595000,-50000,-8.4,10,Dublin,Leinster
137,2022-11-17," 308 Sundays Well, Naas, Kildare ",375000,379000,-4000,-1.06,10,Kildare,Leinster
138,2022-11-17," Tulligee, Clonakilty, West Cork ",350000,360000,-10000,-2.78,10,Cork,Munster
139,2022-11-17," 71 Carton House, The Oaks, Ridgewood, Swords,   County Dublin ",270000,280000,-10000,-3.57,10,Dublin,Leinster
140,2022-11-17," 19 Fernhill , Arklow, Wicklow ",289000,325000,-36000,-11.08,10,Wicklow,Leinster
141,2022-11-17," Old Creagh School, Creagh, Baltimore, Cork ",100000,80000,20000,25.0,10,Cork,Munster
142,2022-11-17," Gormanston Road, Stamullen, Meath ",315000,325000,-10000,-3.08,10,Meath,Leinster
143,2022-11-17," 17 Monastery Heath Court, Clondalkin, Dublin 22 ",225000,245000,-20000,-8.16,10,Dublin 22,Leinster
144,2022-11-17," 21 Pebble Drive, Pebble Beach, Tramore, Waterford ",155000,165000,-10000,-6.06,10,Waterford,Munster
145,2022-11-17," Old Labour Exchange, Quay Road, Dungloe, Donegal ",130000,165000,-35000,-21.21,10,Donegal,Ulster
146,2022-11-17," 10 Griffeen Glen Drive, Lucan, County Dublin ",565000,445000,120000,26.97,10,Dublin,Leinster
147,2022-11-16," 65 The Glen, Portarlington, Co. Laois ",199000,210000,-11000,-5.24,10,Laois,Leinster
148,2022-11-16," 3 Malone Gardens, Sandymount, Dublin 4 ",795000,850000,-55000,-6.47,10,Dublin 4,Leinster
149,2022-11-16," 10 O`Connell Terrace, Clonmel, Co. Tipperary ",115000,140000,-25000,-17.86,10,Tipperary,Munster
150,2022-11-16," 39 Mill Hill Park, Skerries, Co. Dublin ",470000,495000,-25000,-5.05,10,Dublin,Leinster
152,2022-11-16," 40 The Cloisters, Abbeydorney, Kerry ",199000,210000,-11000,-5.24,11,Kerry,Munster
153,2022-11-16," 23 Abbey Drive, Abbey Park, Ferrybank, Waterford ",169000,173000,-4000,-2.31,11,Waterford,Munster
154,2022-11-16," 15 Briarwood, Slieverue, Kilkenny ",349000,369000,-20000,-5.42,11,Kilkenny,Leinster
155,2022-11-16," 1 Tivoli  Villas, Middle Glanmire Road, Tivoli, Cork City ",315000,345000,-30000,-8.7,11,Cork,Munster
156,2022-11-16," 124 Roselawn Road, Castleknock, Dublin 15 ",525000,550000,-25000,-4.55,11,Dublin 15,Leinster
158,2022-11-16," Leitrim Road, Carrick-on-Shannon, Co. Leitrim ",385000,319000,66000,20.69,11,Leitrim,Connaught
159,2022-11-16," 24 Applewood Avenue East, Swords, County Dublin ",270000,285000,-15000,-5.26,11,Dublin,Leinster
160,2022-11-16," 98 Green Rd, Carlow Town, Carlow ",199000,235000,-36000,-15.32,11,Carlow,Leinster
161,2022-11-16," 13 Macdonagh Junction, Kilkenny, Co. Kilkenny, Kilkenny, Kilkenny ",165000,131000,34000,25.95,11,Kilkenny,Leinster
162,2022-11-16," 81 Claremont Park, Rahoon, Galway City ",280000,290000,-10000,-3.45,11,Galway,Connaught
163,2022-11-16," 68 Sheelin Road, Caherdavin Park, Caherdavin, Limerick City ",232500,245000,-12500,-5.1,11,Limerick,Munster
164,2022-11-16," Apartment 49 Reuben Square Block B, Reuben Street, South City Centre, Dublin ",345000,340000,5000,1.47,11,Dublin,Leinster
165,2022-11-16," 11 Rutland Grove, Crumlin, Dublin 12 ",300000,345000,-45000,-13.04,11,Dublin 12,Leinster
166,2022-11-16," 64 Eden Villas, Glasthule, Sandycove, Co. Dublin ",395000,430000,-35000,-8.14,11,Dublin,Leinster
167,2022-11-16," 22 Corrig Park, Dun Laoghaire, County Dublin ",570000,600000,-30000,-5.0,12,Dublin,Leinster
168,2022-11-16," Townspark House, Old Bog Road, Ardee, Louth ",500000,550000,-50000,-9.09,12,Louth,Leinster
169,2022-11-16," Clonbun,Trim,Co. Meath ",80000,90000,-10000,-11.11,12,Meath,Leinster
170,2022-11-15," 14 Alderwood Close, Tallaght,   Dublin 24 ",290000,270000,20000,7.41,12,Dublin 24,Leinster
171,2022-11-15," 70 Blessington Street , Broadstone, Dublin 7 ",850000,995000,-145000,-14.57,12,Dublin 7,Leinster
173,2022-11-15," Aglish, Mooncoin, Co. Kilkenny ",139000,170000,-31000,-18.24,12,Kilkenny,Leinster
174,2022-11-15," 36 Blackmillers Hill, Kildare Town, Kildare ",355000,340000,15000,4.41,12,Kildare,Leinster
175,2022-11-15," 53 Blackmillers Hill, Kildare Town, Kildare ",355000,315000,40000,12.7,12,Kildare,Leinster
176,2022-11-15," 178 Charlesland Park, Greystones, Co. Wicklow ",450000,465000,-15000,-3.23,12,Wicklow,Leinster
177,2022-11-15," 27 Windmill Avenue, Crumlin, Dublin 12 ",299950,325000,-25050,-7.71,12,Dublin 12,Leinster
178,2022-11-15," 8 Radharc An Chlair, Gratton Road, Galway City, Galway, Co. Galway ",250000,265000,-15000,-5.66,12,Galway,Connaught
179,2022-11-15," 28 Allen Manor, Kilmeague, Naas, Kildare ",275000,295000,-20000,-6.78,13,Kildare,Leinster
180,2022-11-15," Towlaght, Clonard, Meath ",220000,225000,-5000,-2.22,13,Meath,Leinster
181,2022-11-15," Apartment 6 The Harbour, Market Point,, Mullingar, Westmeath ",169000,170000,-1000,-0.59,13,Westmeath,Leinster
182,2022-11-15," Beulah, 21 Ferrybank, Arklow, Wicklow ",425000,475000,-50000,-10.53,13,Wicklow,Leinster
183,2022-11-15," 12 Cnoc a Run, Scartaglen, Killarney, Kerry ",250000,280000,-30000,-10.71,13,Kerry,Munster
184,2022-11-15," 282 Marina Village, Malahide, Dublin ",795000,825000,-30000,-3.64,13,Dublin,Leinster
185,2022-11-15," Castlewarren, Kilkenny, Kilkenny ",375000,385000,-10000,-2.6,13,Kilkenny,Leinster
186,2022-11-15," Camden Lock, Ringsend, Dublin 4 ",385000,410000,-25000,-6.1,13,Dublin 4,Leinster
187,2022-11-15," Butlerswood, Windgap, Kilkenny ",100000,110000,-10000,-9.09,13,Kilkenny,Leinster
188,2022-11-15," 79 Castle Riada Avenue, Lucan, Dublin ",375000,389950,-14950,-3.83,13,Dublin,Leinster
189,2022-11-15," Manderley, Rooskey, Roscommon ",600000,595000,5000,0.84,13,Roscommon,Connaught
190,2022-11-15," 29 The Lodge, Castledargan, Ballygawley, Sligo ",300000,350000,-50000,-14.29,13,Sligo,Connaught
191,2022-11-15," Shanaclough, Enniskeane, Cork ",110000,125000,-15000,-12.0,13,Cork,Munster
192,2022-11-15," 11 Faulkners Terrace, Mount Brown, Kilmainham, Dublin ",495000,510000,-15000,-2.94,13,Dublin,Leinster
193,2022-11-15," Apartment 5, The Salt House, Salthouse Lane, Wicklow Town, Wicklow ",205000,235000,-30000,-12.77,13,Wicklow,Leinster
194,2022-11-15," 34 Summerhill, Nenagh, Co. Tipperary ",175000,145000,30000,20.69,14,Tipperary,Munster
195,2022-11-14," 95 Parchment Square, Model Farm Road,   Cork City ",183500,180000,3500,1.94,14,Cork,Munster
196,2022-11-14," Clashadoo, Durrus,   West Cork ",360000,420000,-60000,-14.29,14,Cork,Munster
197,2022-11-14," Clashadoo, Durrus, West Cork ",360000,420000,-60000,-14.29,14,Cork,Munster
198,2022-11-14," Knocknaconny, Ballaghaderreen, Roscommon ",169000,179000,-10000,-5.59,14,Roscommon,Connaught
199,2022-11-14," 228 Cathedral Road, Gurranabraher, City Centre Nth, Cork City ",170000,190000,-20000,-10.53,14,Cork,Munster
200,2022-11-14," 49 Marina Village, Malahide, County Dublin ",450000,490000,-40000,-8.16,14,Dublin,Leinster
201,2022-11-14," 40 Rockfield Road, Kells, Co Meath A82 D7E2 ",270000,275000,-5000,-1.82,14,Meath,Leinster
202,2022-11-14," 13 castlegate row, Lucan, Dublin ",369000,395000,-26000,-6.58,14,Dublin,Leinster
203,2022-11-14," Lea Road, Portarlington, Laois ",250000,280000,-30000,-10.71,14,Laois,Leinster
204,2022-11-14," 40 Chapelwood, Kilmuckridge, Wexford ",270000,280000,-10000,-3.57,14,Wexford,Leinster
205,2022-11-14," 33 Bishop Rogan Park, Kilcullen, Kildare ",219950,229950,-10000,-4.35,14,Kildare,Leinster
206,2022-11-14," 10 Hollybank Crescent, Clongowen, Kilkenny, Kilkenny ",195000,225000,-30000,-13.33,14,Kilkenny,Leinster
207,2022-11-14," 18 Willow Drive, Bellfield, Ferrybank, Waterford ",255000,245000,10000,4.08,14,Waterford,Munster
208,2022-11-14," 10 Chapelfields, Urlingford, Kilkenny ",165000,175000,-10000,-5.71,14,Kilkenny,Leinster
209,2022-11-14," 20 Maudlin Street, Kilkenny, Kilkenny ",260000,285000,-25000,-8.77,14,Kilkenny,Leinster
210,2022-11-14," 6 Lansdowne Close, Portarlington, Laois ",235000,245000,-10000,-4.08,14,Laois,Leinster
211,2022-11-14," 82 Applewood Heights Greystones, Greystones, Wicklow ",625000,475000,150000,31.58,15,Wicklow,Leinster
212,2022-11-14," Four Bedroom Semi-Detached Residence, 9 The Park, Blessington Abbey, Blessington, Wicklow ",415000,425000,-10000,-2.35,15,Wicklow,Leinster
213,2022-11-14," 26 Inver Geal, Cortober, Carrick-on-Shannon, Roscommon ",135000,145000,-10000,-6.9,15,Roscommon,Connaught
214,2022-11-14," 4 Belmont Avenue, Ballinlough, Cork ",297500,320000,-22500,-7.03,15,Cork,Munster
215,2022-11-14," Apartment 6, Lee Vista, Cork City, Cork ",190000,185000,5000,2.7,15,Cork,Munster
216,2022-11-14," Lee View, Mount Ovel, Rochestown, Cork ",349500,375000,-25500,-6.8,15,Cork,Munster
217,2022-11-14," 8 Corkhill, Kinnegad, Westmeath ",199950,230000,-30050,-13.07,15,Westmeath,Leinster
218,2022-11-14," Ballinruan, Crusheen, Caher, Clare ",550000,395000,155000,39.24,15,Clare,Munster
219,2022-11-14," Attycristora, Lahinch, Clare ",655000,695000,-40000,-5.76,15,Clare,Munster
220,2022-11-14," No 7 Maryville Gardens, Courtown, Gorey, Wexford ",165000,178000,-13000,-7.3,15,Wexford,Leinster
221,2022-11-14," 16 The Walnut, Grattan Wood, Donaghmede, Dublin 13 ",270000,225000,45000,20.0,15,Dublin 13,Leinster
222,2022-11-13," Apartment 4, Watermill Place, Market Square, Monasterevin, Kildare ",135000,130000,5000,3.85,15,Kildare,Leinster
223,2022-11-11," Gallowhill, Athy, Kildare ",320000,310000,10000,3.23,15,Kildare,Leinster
224,2022-11-11," 123 Newhaven Bay, Balbriggan, County Dublin ",265000,295000,-30000,-10.17,15,Dublin,Leinster
225,2022-11-11," Site at Beechfield, Castletroy, Co. Limerick ",250000,275000,-25000,-9.09,15,Limerick,Munster
226,2022-11-11," 1 Cottage Mews, Johns Hill, Waterford City, Waterford ",135000,170000,-35000,-20.59,16,Waterford,Munster
227,2022-11-11," 146 The Haven, Jacobs Island, Little Island, Cork ",285000,295000,-10000,-3.39,16,Cork,Munster
228,2022-11-11," Site at Beechfield, Castletroy, Limerick ",250000,275000,-25000,-9.09,16,Limerick,Munster
229,2022-11-11," 52 Clonmore Heights, Mullingar, Mullingar, Westmeath ",235000,265000,-30000,-11.32,16,Westmeath,Leinster
230,2022-11-11," 40 Hillcrest, Kilcullen, Kildare ",339950,349950,-10000,-2.86,16,Kildare,Leinster
231,2022-11-11," 3 Clancy Court, Clancy Road, Finglas, Dublin 11 ",395000,350000,45000,12.86,16,Dublin 11,Leinster
232,2022-11-11," Avoca, Barnagearagh, Ballylickey, West Cork, Bantry, Co. Cork ",290000,305000,-15000,-4.92,16,Cork,Munster
233,2022-11-11," 20 Millbrook Drive, Old Tuam Road, Athlone, Co. Roscommon ",205000,219000,-14000,-6.39,16,Roscommon,Connaught
234,2022-11-11," 96 Binn Eadair View, Sutton, Dublin 13., Sutton, Dublin 13 ",395000,425000,-30000,-7.06,16,Dublin 13,Leinster
235,2022-11-11," The Coach House, Glen Of Aherlow, Newtown, Co. Tipperary ",59000,69000,-10000,-14.49,16,Tipperary,Munster
236,2022-11-11," 17 Larch Court, Kennedy Park, City Centre (Limerick), Limerick City ",150000,159000,-9000,-5.66,16,Limerick,Munster
237,2022-11-11," 2 Seacliff, Wicklow Town, Wicklow ",675000,595000,80000,13.45,16,Wicklow,Leinster
238,2022-11-11," 1 Rosary Terrace, Irishtown, Dublin 4 ",499950,524950,-25000,-4.76,16,Dublin 4,Leinster
239,2022-11-11," 'Old Forge' Laught Street, Kilfinane, Limerick ",199000,240000,-41000,-17.08,16,Limerick,Munster
240,2022-11-11," Ritavilla, Turner's Hill, Kingscourt, Cavan ",119000,139000,-20000,-14.39,16,Cavan,Ulster
241,2022-11-11," Turner's Hill, Kingscourt, Cavan ",150000,179000,-29000,-16.2,16,Cavan,Ulster
242,2022-11-11," 48 Abbey Court, Ennis, Clare ",259000,250000,9000,3.6,17,Clare,Munster
243,2022-11-11," 27 Saint Michaels Terrace, Blackpitts, Blackpitts, Dublin 8 ",335000,350000,-15000,-4.29,17,Dublin 8,Leinster
244,2022-11-11," 14 Corran Riada, Athlone West, Westmeath ",130000,150000,-20000,-13.33,17,Westmeath,Leinster
245,2022-11-11," 7 The Pines, Sea Road, Arklow, Wicklow ",340000,355000,-15000,-4.23,17,Wicklow,Leinster
246,2022-11-11," 14 Springdale, Clonattin Village, Gorey, Wexford ",195000,215000,-20000,-9.3,17,Wexford,Leinster
248,2022-11-10," Mistletoe House, Main Street, Borris-in-Ossory, Laois ",260000,299000,-39000,-13.04,17,Laois,Leinster
249,2022-11-10," 50 Summerdale Lawn, Youghal, Cork ",300000,315000,-15000,-4.76,17,Cork,Munster
250,2022-11-10," Glenoory,Downings,Co Donegal,F92 F662 ",495000,450000,45000,10.0,17,Donegal,Ulster
251,2022-11-10," 11 Shangort Park, Shangort Road, Knocknacarra, Co. Galway ",550000,498000,52000,10.44,17,Galway,Connaught
252,2022-11-10," 16 Aughavannagh Road, Crumlin, Dublin 12 ",445000,395000,50000,12.66,17,Dublin 12,Leinster
253,2022-11-10," 10 Slí na gCapall, Ballymore, Craughwell, Galway ",280000,295000,-15000,-5.08,17,Galway,Connaught
254,2022-11-10," 1A Slievenamon Road, Drimnagh, Dublin 12 ",375000,325000,50000,15.38,17,Dublin 12,Leinster
255,2022-11-10," 28 Loughmahon Road, Mahon, Cork ",205000,225000,-20000,-8.89,17,Cork,Munster
256,2022-11-10," 3 The Willows, Togher Beg, Roundwood, Wicklow ",595000,445000,150000,33.71,18,Wicklow,Leinster
257,2022-11-10," 4 The Willows, Togher Beg, Roundwood, Wicklow ",445000,595000,-150000,-25.21,18,Wicklow,Leinster
258,2022-11-10," 10 Willow Green, Athlumney Wood, Navan, Co. Meath ",300000,320000,-20000,-6.25,18,Meath,Leinster
259,2022-11-10," 3 Tir Croghan, Kinnegad, Westmeath ",215000,240000,-25000,-10.42,18,Westmeath,Leinster
260,2022-11-10," No. 3 Cois Farraige, Kilkee, Co. Clare V15 HC61, Co. Clare ",185000,198000,-13000,-6.57,18,Clare,Munster
261,2022-11-10," 3 Cois Na Farraige, Kilkee, Clare ",185000,198000,-13000,-6.57,18,Clare,Munster
262,2022-11-10," 27 Windmill Avenue, Swords, County Dublin ",455000,465000,-10000,-2.15,18,Dublin,Leinster
263,2022-11-10," Suite 100, Powerscourt Autograph Collection Hotel, , Enniskerry, Wicklow ",280000,320000,-40000,-12.5,18,Wicklow,Leinster
264,2022-11-10," Grantham House Mews, Rathgar Avenue, Rathgar,   Dublin 6 ",915000,975000,-60000,-6.15,18,Dublin 6,Leinster
265,2022-11-10," Murreagh, Waterville, Kerry ",520000,545000,-25000,-4.59,18,Kerry,Munster
266,2022-11-10," Crofton Cottage,Glen Lane,Ballinakill,Ferns,Co. Wexford ",299000,325000,-26000,-8.0,18,Wexford,Leinster
267,2022-11-09," 12 Drumboe Cottages, Stranorlar, Co. Donegal ",90000,99000,-9000,-9.09,18,Donegal,Ulster
269,2022-11-09," 13 Euston St, Greenore, Co. Louth ",210000,160000,50000,31.25,18,Louth,Leinster
270,2022-11-09," 29 Shantraud Woods, Killaloe, Clare ",275000,295000,-20000,-6.78,18,Clare,Munster
271,2022-11-09," 130 New Seskin Court, Tallaght, Dublin 24 ",225000,229000,-4000,-1.75,18,Dublin 24,Leinster
272,2022-11-09," Kinnalough, Fanad, Co. Donegal ",80000,100000,-20000,-20.0,19,Donegal,Ulster
273,2022-11-09," 35 Parker House, The Coast, Baldoyle, Dublin ",360000,375000,-15000,-4.0,19,Dublin,Leinster
274,2022-11-09,"  35 Parker House, The Coast, Baldoyle, Dublin 13 ",360000,375000,-15000,-4.0,19,Dublin 13,Leinster
275,2022-11-09," Shannakeela, Recess, Galway ",160000,150000,10000,6.67,19,Galway,Connaught
276,2022-11-09," No. 40 Lr Midleton Street, Cobh, Co Cork , Cobh, East Cork ",220000,230000,-10000,-4.35,19,Cork,Munster
277,2022-11-09," 81 Sundale Avenue, Tallaght,   Dublin 24 ",250000,265000,-15000,-5.66,19,Dublin 24,Leinster
278,2022-11-09," Toberleheen, Ballinagar, Offaly ",399000,425000,-26000,-6.12,19,Offaly,Leinster
280,2022-11-09," 22 Davis Court, Inchicore, Dublin 8 ",285000,250000,35000,14.0,19,Dublin 8,Leinster
281,2022-11-09," 1 Friar Street, Youghal, Cork ",249000,265000,-16000,-6.04,19,Cork,Munster
282,2022-11-09," Coumnagalla, Kilcommon, Thurles, Co. Tipperary ",99950,69950,30000,42.89,19,Tipperary,Munster
283,2022-11-09," Cul Rua, Brown Street, Poleberry, Portlaw, Co. Waterford ",195000,199000,-4000,-2.01,19,Waterford,Munster
284,2022-11-09," 37 Curragh Park, Mullagh, Cavan ",235000,250000,-15000,-6.0,19,Cavan,Ulster
288,2022-11-09," The Willows, Pembrokestown, Duncormick, Wexford ",340000,395000,-55000,-13.92,20,Wexford,Leinster
289,2022-11-09," 33 Devon Park, Salthill, Co. Galway ",610000,595000,15000,2.52,20,Galway,Connaught
290,2022-11-09," Coornagillagh, Tuosist, Kenmare, Co. Kerry ",295000,315000,-20000,-6.35,20,Kerry,Munster
291,2022-11-09," 73 Donore Avenue, South Circular Road, Dublin 8 ",550000,580000,-30000,-5.17,20,Dublin 8,Leinster
292,2022-11-09," 3 The Drive, Milltree Park, Ratoath, Co. Meath, Ratoath, Meath ",355000,325000,30000,9.23,20,Meath,Leinster
293,2022-11-08," 2 The Tanager, Barnageeragh Cove, Skerries, Dublin ",650000,625000,25000,4.0,20,Dublin,Leinster
294,2022-11-08," Moorland Cottage, Annies, Hollymount, Mayo ",95000,89000,6000,6.74,20,Mayo,Connaught
295,2022-11-08," The Oval, 33 Tullyvale, Cabinteely, Dublin 18 ",265000,280000,-15000,-5.36,20,Dublin 18,Leinster
296,2022-11-08," 17 Riverchapel Square, Riverchapel Wood, Courtown, Wexford ",249000,255000,-6000,-2.35,20,Wexford,Leinster
297,2022-11-08," 4 Highfield, Dublin road, Arklow, Wicklow ",400000,450000,-50000,-11.11,21,Wicklow,Leinster
298,2022-11-08," 44 Willow Green, Athlumney Wood, Navan, Meath ",285000,295000,-10000,-3.39,21,Meath,Leinster
299,2022-11-08," Apartment 2 Block J , Hanover Riverside, Forbes Street, Grand Canal Dk, Dublin ",590000,620000,-30000,-4.84,21,Dublin,Leinster
300,2022-11-08," Knockduff, Ballindaggin Prime  C. House On C. 1 acres., Enniscorthy, Wexford ",120000,150000,-30000,-20.0,21,Wexford,Leinster
301,2022-11-08," Knockduff, Ballindaggin Prime  C. House On C. 7.495 acres., Enniscorthy, Wexford ",150000,480000,-330000,-68.75,21,Wexford,Leinster
302,2022-11-08," 55 Na Cluainte, Kilmalogue, Portarlington, Co. Laois ",219500,225000,-5500,-2.44,21,Laois,Leinster
303,2022-11-08," 54 Brocan Wood, Monasterevin, Co. Kildare ",329000,345000,-16000,-4.64,21,Kildare,Leinster
304,2022-11-08," Unit 19 & 20 Greenmount Industrial Estate, Harold's Cross, Dublin ",340000,375000,-35000,-9.33,21,Dublin,Leinster
305,2022-11-08," 14 Rosemount Court, Kilmainham, Dublin 8 ",285000,295000,-10000,-3.39,21,Dublin 8,Leinster
306,2022-11-08," No.6 Thornbrook, The Ballagh, Enniscorthy, Wexford ",193000,199000,-6000,-3.02,21,Wexford,Leinster
307,2022-11-08," Lisdrumneil, Fairymount, Castlerea, Roscommon ",12000,14000,-2000,-14.29,21,Roscommon,Connaught
308,2022-11-08," 75 Furry Park Road, Killester, Dublin 5 ",725000,775000,-50000,-6.45,21,Dublin 5,Leinster
309,2022-11-08," 50 Tailteann Court, Mullingar, Westmeath ",150000,169950,-19950,-11.74,21,Westmeath,Leinster
310,2022-11-07," 18 Mungret Woods, Raheen, Co. Limerick, Mungret, Limerick ",295000,310000,-15000,-4.84,21,Limerick,Munster
311,2022-11-07," Millers House, Mill Street, Borrisokane, Co. Tipperary ",299950,350000,-50050,-14.3,21,Tipperary,Munster
312,2022-11-07," 35 Sean Moylan Park, Mallow, Co. Cork ",160000,165000,-5000,-3.03,22,Cork,Munster
315,2022-11-07," 84 Irishtown,Clonmel,Co. Tipperary,E91 E7K7 ",160000,175000,-15000,-8.57,22,Tipperary,Munster
316,2022-11-07," 13 Sliabh Cairbe, Drumlish, Longford ",179000,185000,-6000,-3.24,22,Longford,Leinster
317,2022-11-07," Knocknacarrow, Cootehall, Boyle, Co. Roscommon ",199000,149900,49100,32.76,22,Roscommon,Connaught
318,2022-11-07," Glendarragh, Templeglantine, Co. Limerick ",155000,175000,-20000,-11.43,22,Limerick,Munster
319,2022-11-07," Keadue, Burtonport, Donegal ",159950,169950,-10000,-5.88,22,Donegal,Ulster
320,2022-11-07," 36 Ivar Street, Stoneybatter,   Dublin 7 ",395000,425000,-30000,-7.06,22,Dublin 7,Leinster
321,2022-11-07," 2, Ballinwillin, Mitchelstown, Cork ",295000,320000,-25000,-7.81,22,Cork,Munster
324,2022-11-07," 4 Bedroom Semi Detached - Farnan Wood, Downings North, Prosperous, Kildare ",445000,395000,50000,12.66,22,Kildare,Leinster
326,2022-11-07," 163 Beaumont Road, Beaumont, Dublin 9 ",395000,425000,-30000,-7.06,22,Dublin 9,Leinster
327,2022-11-07," Nicos, Main Street, Schull,   West Cork ",980000,1200000,-220000,-18.33,22,Cork,Munster
328,2022-11-07," Enaghbeg, Crossmolina, Mayo ",40000,57500,-17500,-30.43,23,Mayo,Connaught
329,2022-11-07," 23 Ashbrooke Grove, Moynehall, Cavan Town ",260000,255000,5000,1.96,23,Cavan,Ulster
332,2022-11-07," 106 Castle Park, Tallaght, Dublin 24 ",275000,295000,-20000,-6.78,23,Dublin 24,Leinster
333,2022-11-07," 23 Rockfield Manor, Coolaney, Co. Sligo ",159000,165000,-6000,-3.64,23,Sligo,Connaught
334,2022-11-07," 2 Somers Way, Ballycullane, Wexford ",185000,175000,10000,5.71,23,Wexford,Leinster
335,2022-11-07," 187 The George, Charlotte Quay Dock, Grand Canal Dk, Dublin 4 ",480000,500000,-20000,-4.0,23,Dublin 4,Leinster
336,2022-11-07," 37 Hermitage Park, Kilcullen, Kildare ",260000,275000,-15000,-5.45,23,Kildare,Leinster
337,2022-11-07," 22 Annaly Drive, Ongar, Dublin ",295000,315000,-20000,-6.35,23,Dublin,Leinster
338,2022-11-07," 5 Griffeen Glen Court, Lucan, Dublin ",370000,380000,-10000,-2.63,23,Dublin,Leinster
339,2022-11-06," 48 Old Market Place, City Centre Nth, Cork ",165000,215000,-50000,-23.26,23,Cork,Munster
340,2022-11-06," 7 Derry Drive, Crumlin, Dublin 12 ",285000,299950,-14950,-4.98,23,Dublin 12,Leinster
341,2022-11-05," 51 Shingan,Milehouse,Enniscorthy,Co Wexford.,Y21XOE3 ",184000,189000,-5000,-2.65,23,Wexford,Leinster
342,2022-11-05," 54 Willowomere , Thurles, Tipperary ",320000,295000,25000,8.47,23,Tipperary,Munster
343,2022-11-05," Eighty Eight Acres,Athboy,Co Meath,C15 YT96 ",360000,420000,-60000,-14.29,24,Meath,Leinster
344,2022-11-04," Coolishall Cottage,Gorey,Co. Wexford,Y25 H6R6 ",300000,350000,-50000,-14.29,24,Wexford,Leinster
345,2022-11-04," Apartment 32, The Towers, Mallow, Co. Cork ",175000,180000,-5000,-2.78,24,Cork,Munster
346,2022-11-04," Doughiska Road, Co. Galway ",475000,495000,-20000,-4.04,24,Galway,Connaught
347,2022-11-04," 1 Sydenham Road, Ballsbridge, Dublin 4 ",2450000,2700000,-250000,-9.26,24,Dublin 4,Leinster
348,2022-11-04," Hiskinstown GC, Delvin, Co Westmeath ",55000,35000,20000,57.14,24,Westmeath,Leinster
349,2022-11-04," 7 Harolds Cross Road, Harold's Cross, Dublin 6W ",595000,695000,-100000,-14.39,24,Dublin,Leinster
350,2022-11-04," Rathcormac, North Sligo, Sligo ",50000,65000,-15000,-23.08,24,Sligo,Connaught
351,2022-11-04," Grange West, Knocknahur, Sligo ",65000,80000,-15000,-18.75,24,Sligo,Connaught
352,2022-11-04," Tomsallagh, Ferns, Wexford ",190000,200000,-10000,-5.0,24,Wexford,Leinster
353,2022-11-04," Hayestown, Rush, County Dublin ",280000,300000,-20000,-6.67,24,Dublin,Leinster
354,2022-11-04," Two bedroom Cottage, No.3 Chapel Street, Ballymore Eustace, Kildare ",325000,350000,-25000,-7.14,24,Kildare,Leinster
355,2022-11-04," 30 Heathfield Close, Kinnegad, Westmeath ",230000,245000,-15000,-6.12,24,Westmeath,Leinster
356,2022-11-04," 10 Boyne Meadows, Edenderry, Offaly ",230000,245000,-15000,-6.12,24,Offaly,Leinster
357,2022-11-04," 307 Massford Castlecomer Co Kilkenny, Castlecomer, Kilkenny ",138000,175000,-37000,-21.14,24,Kilkenny,Leinster
358,2022-11-04," 8 Oakfield Court, Glanmire, Cork ",315000,330000,-15000,-4.55,24,Cork,Munster
359,2022-11-04," Galway City, Galway, Co. Galway ",30000,40000,-10000,-25.0,25,Galway,Connaught
360,2022-11-04," Macetown, Navan, Meath ",395000,350000,45000,12.86,25,Meath,Leinster
361,2022-11-04," 11 Woodlands, Lackagh, Turloughmore, Co. Galway ",280000,295000,-15000,-5.08,25,Galway,Connaught
362,2022-11-04," 13 Bolands Court, Gort, Galway ",195000,225000,-30000,-13.33,25,Galway,Connaught
363,2022-11-03," 29 Willow Green,Athlumney Wood,Navan,Co. Meath,C15 FHN2 ",295000,300000,-5000,-1.67,25,Meath,Leinster
364,2022-11-03," 16 Park Way Grangerath, Drogheda, Meath ",349000,365000,-16000,-4.38,25,Meath,Leinster
365,2022-11-03," 59 Chapel Farm Road, Lusk, Co. Dublin ",290000,315000,-25000,-7.94,25,Dublin,Leinster
366,2022-11-03," 13 Kent Road, Ballyphehane, Cork City ",245000,265000,-20000,-7.55,25,Cork,Munster
367,2022-11-03," Kilcoe, 17 Saint James Court, Ennis Road, Co. Limerick, Ennis Road, Limerick ",289000,310000,-21000,-6.77,25,Limerick,Munster
368,2022-11-03," Unit 4 Blessington Industrial Estate, Blessington, Wicklow ",169000,195000,-26000,-13.33,25,Wicklow,Leinster
369,2022-11-03," Bawn, Mansfieldtown, Castlebellingham, Louth ",725000,780000,-55000,-7.05,25,Louth,Leinster
370,2022-11-03," 6 Rivercourt,, Goresbridge, Kilkenny ",215000,245000,-30000,-12.24,25,Kilkenny,Leinster
372,2022-11-03," 1 Lennox Street, Portobello, Dublin 8 ",875000,900000,-25000,-2.78,26,Dublin 8,Leinster
373,2022-11-03," Rathkieran, Co.Kilkenny, Waterford City Centre, Mooncoin, Co. Kilkenny ",170000,180000,-10000,-5.56,26,Kilkenny,Leinster
375,2022-11-03," 22 Academy Court, Academy Steet, Kildare Town, Kildare ",210000,225000,-15000,-6.67,26,Kildare,Leinster
376,2022-11-03," Eversley, 3 The Meadows, Cornelscourt, Newbridge, Kildare ",289000,320000,-31000,-9.69,26,Kildare,Leinster
377,2022-11-03," 4 The Square, Freshford, Kilkenny ",160000,145000,15000,10.34,26,Kilkenny,Leinster
378,2022-11-03," 20 Woodlands, Tralee, Kerry ",200000,210000,-10000,-4.76,26,Kerry,Munster
379,2022-11-03," 94 Cluain Alainn, Carrickmacross, Co. Monaghan ",265000,249000,16000,6.43,26,Monaghan,Ulster
380,2022-11-03," NO. 18 CHANDLERS REST, RUSHBROOK LINKS, COBH, CO CORK , Cobh, East Cork ",249000,265000,-16000,-6.04,26,Cork,Munster
381,2022-11-03," 62/63 O Brien Street, Tipperary Town, Tipperary ",120000,250000,-130000,-52.0,26,Tipperary,Munster
382,2022-11-03," 2 Clermont Cottages South Douglas Road, Douglas, Cork ",245000,255000,-10000,-3.92,26,Cork,Munster
383,2022-11-03," Mill Road, Glanworth, Cork ",140000,160000,-20000,-12.5,26,Cork,Munster
384,2022-11-02," 113 Droim Liath,Tullamore,Co Offaly,R35 A5X0 ",225000,230000,-5000,-2.17,26,Offaly,Leinster
385,2022-11-02," 2 Rose Arden, Sundays Well, Co. Cork ",310000,315000,-5000,-1.59,26,Cork,Munster
386,2022-11-02," Main Street, Cloughjordan, Co. Tipperary ",179950,149950,30000,20.01,26,Tipperary,Munster
387,2022-11-02," The Gables,Shingaun,Milehouse,Enniscorthy,Co.Wexford ",335000,350000,-15000,-4.29,27,Wexford,Leinster
388,2022-11-02," Tarmon, Kilrush, Clare ",130000,135000,-5000,-3.7,27,Clare,Munster
389,2022-11-02," 3 Castle View Court, Delvin, Westmeath ",150000,155000,-5000,-3.23,27,Westmeath,Leinster
390,2022-11-02," No. 8 St. Patricks Terrace, Magazine Rd , City Centre Sth,   Cork City ",268000,280000,-12000,-4.29,27,Cork,Munster
391,2022-11-02," Carhooearagh, Listowel, Kerry ",65000,75000,-10000,-13.33,27,Kerry,Munster
392,2022-11-02," The Willows,Tullykeel, Ardee, Louth ",399000,449000,-50000,-11.14,27,Louth,Leinster
393,2022-11-02," 17 Mountfield , Tramore, Waterford ",295000,299000,-4000,-1.34,27,Waterford,Munster
394,2022-11-02," 76 Burnell Square, Northern Cross, Dublin 17 ",285000,299000,-14000,-4.68,27,Dublin 17,Leinster
395,2022-11-02," Roundfort , Hollymount, Mayo ",195000,225000,-30000,-13.33,27,Mayo,Connaught
396,2022-11-02," 41 Garnish Square, Waterville, Blanchardstown,   Dublin 15 ",320000,350000,-30000,-8.57,27,Dublin 15,Leinster
397,2022-11-02," 40 Annagh Court, Waterville, Blanchardstown,   Dublin 15 ",320000,350000,-30000,-8.57,27,Dublin 15,Leinster
398,2022-11-01," Carraig Lea, Maghera, Shinrone, Birr, Co. Offaly ",160000,200000,-40000,-20.0,28,Offaly,Leinster
399,2022-11-01," Mount Mary,Ballygar,Co Galway,F42 E361 ",350000,290000,60000,20.69,28,Galway,Connaught
400,2022-11-01," 24 Goldenbridge Avenue, Inchicore, Dublin 8 ",385000,325000,60000,18.46,28,Dublin 8,Leinster
401,2022-11-01," 3 An Sruthan,Loughrea,Co. Galway,H62 D793 ",205000,215000,-10000,-4.65,28,Galway,Connaught
402,2022-11-01," 3 TJ Murphy Terrace, Old Waterpark, Carrigaline, Cork ",260000,275000,-15000,-5.45,28,Cork,Munster
403,2022-11-01," Apt 24 Blacklion Manor, Greystones, Co. Wicklow ",360000,390000,-30000,-7.69,28,Wicklow,Leinster
404,2022-11-01," No. 80 Sweetbriar Lawn, Tramore, Waterford ",305000,315000,-10000,-3.17,28,Waterford,Munster
405,2022-11-01," 53 Rialto  Court, Rialto, Dublin 8 ",190000,205000,-15000,-7.32,28,Dublin 8,Leinster
406,2022-11-01," Unit 3 Park Lane, Carrick on Shannon, Co Leitrim N41 K197 ",85000,90000,-5000,-5.56,28,Leitrim,Connaught
407,2022-11-01," 41 Westpark , Blessington, Wicklow ",285000,299000,-14000,-4.68,29,Wicklow,Leinster
408,2022-11-01," 2 Kilmalum Green, Blessington, Wicklow ",385000,395000,-10000,-2.53,29,Wicklow,Leinster
409,2022-10-30," 3 Elm Grove, Lucan, Dublin ",430000,445000,-15000,-3.37,29,Dublin,Leinster
410,2022-10-29," Amerlen Cove,Doctor's Lane,Rush,Co Dublin,K56 KH51 ",545000,595000,-50000,-8.4,29,Dublin,Leinster
411,2022-10-28," Apt 5 The Avenue,Abbeylands,Clane,Co. Kildare ",189000,209000,-20000,-9.57,29,Kildare,Leinster
413,2022-10-28," 2 St. Anne's,Brideswell,Bonavalley,Athlone,Co. Westmeath ",295000,325000,-30000,-9.23,29,Westmeath,Leinster
414,2022-10-28," 95 Old Balreask Woods, Navan, Co. Meath ",435000,450000,-15000,-3.33,29,Meath,Leinster
415,2022-10-28," 30, Ounavarra Park, Ballycanew, Co. Wexford ",179950,190000,-10050,-5.29,29,Wexford,Leinster
416,2022-10-28," 2 Maulnaskehy, Park Road, Clonakilty,   West Cork ",299000,320000,-21000,-6.56,29,Cork,Munster
417,2022-10-28," 8 Ben Edair Road, Stoneybatter, Dublin 7 ",365000,360000,5000,1.39,29,Dublin 7,Leinster
418,2022-10-28," 154 Woodlands, Navan, Meath ",375000,395000,-20000,-5.06,29,Meath,Leinster
419,2022-10-28," Derryhallagh, Drumshanbo, Leitrim ",70000,68000,2000,2.94,29,Leitrim,Connaught
420,2022-10-28," Drumhierny, Leitrim Village, Leitrim ",50000,40000,10000,25.0,30,Leitrim,Connaught
421,2022-10-28," 54 Cul Rua,Aglish,Co Waterford,P51P5C3 ",169000,174500,-5500,-3.15,30,Waterford,Munster
423,2022-10-28," Kilmichael, Castletown, Wexford ",499000,549000,-50000,-9.11,30,Wexford,Leinster
424,2022-10-28," 23 Fforester Drive, Ballydowd Manor, Lucan, Dublin ",360000,350000,10000,2.86,30,Dublin,Leinster
425,2022-10-28," Wheatfield,Great Common,Lusk,Co Dublin,K45 E729 ",685000,735000,-50000,-6.8,30,Dublin,Leinster
426,2022-10-28," Lackagh Village, Lackagh, Galway ",100000,70000,30000,42.86,30,Galway,Connaught
427,2022-10-28," 6 College Court, College Manor, Cobh, Cork ",176000,185000,-9000,-4.86,30,Cork,Munster
428,2022-10-28," Kinkeen, 18 Rosehill, Wicklow Town, Co. Wicklow ",310000,325000,-15000,-4.62,30,Wicklow,Leinster
429,2022-10-28," Highfield House on C.12 acres / 4.86 hectares, Colbinstown, Dunlavin, Wicklow ",725000,675000,50000,7.41,30,Wicklow,Leinster
430,2022-10-28," Highfield House on C.12 acres / 4.86 hectares, Colbinstown, Kilcullen, Kildare ",725000,675000,50000,7.41,30,Kildare,Leinster
431,2022-10-28," Clongour Road, Thurles, Tipperary ",345000,375000,-30000,-8.0,30,Tipperary,Munster
432,2022-10-28," 5 Oaktree Park, Cunnaberry Hill, Kildare Town, Kildare ",325000,300000,25000,8.33,30,Kildare,Leinster
433,2022-10-28," 3 Saint James Terrace, Church Road, Midleton, Co. Cork, Midleton, Cork ",180000,198000,-18000,-9.09,30,Cork,Munster
435,2022-10-28," Cortoon, Shrule, Mayo ",220000,245000,-25000,-10.2,30,Mayo,Connaught
436,2022-10-28," 85 Erris Square, Waterville, Blanchardstown, Dublin 15 ",265000,280000,-15000,-5.36,31,Dublin 15,Leinster
437,2022-10-28," Rose Cottage, Limerick Road, Newmarket on Fergus, Clare ",125000,170000,-45000,-26.47,31,Clare,Munster
438,2022-10-28," 117 Bruach Na Habhainn, Ennis, Clare ",150000,155000,-5000,-3.23,31,Clare,Munster
439,2022-10-27," 15 Grange Court, Stamullen, Co. Meath ",260000,275000,-15000,-5.45,31,Meath,Leinster
440,2022-10-27," Knockdooragh, Headford, Killarney, Kerry ",295000,315000,-20000,-6.35,31,Kerry,Munster
441,2022-10-27," Darbys Hair Salon, Moore Street, Cappamore, Co. Limerick ",149000,160000,-11000,-6.88,31,Limerick,Munster
442,2022-10-27," 23 The Green, Lennonstown Manor, Dundalk, Louth ",200000,195000,5000,2.56,31,Louth,Leinster
443,2022-10-27," 34 The Park, Gorey, Wexford ",270000,280000,-10000,-3.57,31,Wexford,Leinster
444,2022-10-27," 17 Temple Court, Palatine Square , Stoneybatter, Dublin 7 ",445000,475000,-30000,-6.32,31,Dublin 7,Leinster
445,2022-10-27," 17 Seabury Lawn , Mornington, Meath ",165000,180000,-15000,-8.33,31,Meath,Leinster
446,2022-10-27," 21 Oriel Cove, Clogherhead, Louth ",269000,290000,-21000,-7.24,31,Louth,Leinster
447,2022-10-27," 2 Portside Court, East Wall, Dublin 3 ",360000,375000,-15000,-4.0,31,Dublin 3,Leinster
449,2022-10-27," 25 The Bay, Elm Park, Merrion Road, Merrion, Dublin 4 ",529000,429000,100000,23.31,32,Dublin 4,Leinster
450,2022-10-27," 51 Heatherfield, Bailieborough, Cavan ",185000,200000,-15000,-7.5,32,Cavan,Ulster
451,2022-10-27," Taulaght, Saltmills, New Ross, Wexford ",950000,1000000,-50000,-5.0,32,Wexford,Leinster
452,2022-10-27," 39 Beal an Inbhir, Kilrush, Clare ",215000,225000,-10000,-4.44,32,Clare,Munster
453,2022-10-27," 422 Alder Close, Elm Park, Castletroy, Limerick ",220000,195000,25000,12.82,32,Limerick,Munster
454,2022-10-27," Knockatemple Ballyvary, Castlebar, Mayo ",490000,480000,10000,2.08,32,Mayo,Connaught
455,2022-10-27," 55 Station Court, The Avenue, Gorey, Wexford ",200000,215000,-15000,-6.98,32,Wexford,Leinster
456,2022-10-27," 'Ounavarra', Cornakill, Kingscourt, Cavan ",199000,219000,-20000,-9.13,32,Cavan,Ulster
457,2022-10-27," Ballyteague South, Kilmeage, Kildare ",550000,495000,55000,11.11,32,Kildare,Leinster
458,2022-10-27," Killaderry,Ballyforan,Ballinasloe,Co. Galway,H53N510 ",175000,195000,-20000,-10.26,32,Galway,Connaught
459,2022-10-27," Mweelroe,Cloonloo,Boyle,Co Sligo,F52 TW29 ",125000,350000,-225000,-64.29,32,Sligo,Connaught
460,2022-10-26," Graiguenalug, Fighting Cocks, Carlow Town, Co. Carlow ",145000,100000,45000,45.0,32,Carlow,Leinster
461,2022-10-26," Graiguenalug, Fighting Cocks, Co. Carlow ",68500,145000,-76500,-52.76,32,Carlow,Leinster
462,2022-10-26," Derrykinlough, Doocastle, Co. Mayo ",199500,215500,-16000,-7.42,33,Mayo,Connaught
463,2022-10-26," 133 College Manor, Dundalk, Co. Louth ",240000,230000,10000,4.35,33,Louth,Leinster
464,2022-10-26," 5 Gleanntan Na HAbhainn, Killora, Craughwell, Co. Galway ",469000,495000,-26000,-5.25,33,Galway,Connaught
465,2022-10-26," Apt. 3, House 3, Linden Square, Grove Avenue, Stillorgan, County Dublin ",425000,435000,-10000,-2.3,33,Dublin,Leinster
466,2022-10-26," 18 Raithé­n Eoighan, Ashe Road, Mullingar, Westmeath ",169950,184950,-15000,-8.11,33,Westmeath,Leinster
467,2022-10-26," Cappantymore A, Meelick, Co. Clare ",20000,65000,-45000,-69.23,33,Clare,Munster
468,2022-10-26," 'Hawthorn House', Ballygullen, Craanford, Wexford ",545000,599000,-54000,-9.02,33,Wexford,Leinster
469,2022-10-26," Boleybeg East, Barna, Co. Galway ",695000,750000,-55000,-7.33,33,Galway,Connaught
471,2022-10-26," Kybe Cottage, 58 Strand Street, Skerries, Co. Dublin ",720000,800000,-80000,-10.0,33,Dublin,Leinster
472,2022-10-26," 81 East Courtyard, Cabinteely, Dublin 18 ",380000,345000,35000,10.14,33,Dublin 18,Leinster
473,2022-10-26," 75 Goldenbridge Avenue, Inchicore, Dublin 8 ",450000,325000,125000,38.46,33,Dublin 8,Leinster
474,2022-10-26," 29 Mount Leinster Park, Tullow Rd, Carlow Town, Carlow ",239000,249000,-10000,-4.02,33,Carlow,Leinster
475,2022-10-26," Manor Kilbride, Blessington, Wicklow ",719000,732000,-13000,-1.78,33,Wicklow,Leinster
476,2022-10-26," Site at Forest Lodge, Kingswood, Dublin 24 ",795000,875000,-80000,-9.14,33,Dublin 24,Leinster
477,2022-10-26," 91 Cherryfield Lawn, Clonsilla, Dublin 15 ",300000,320000,-20000,-6.25,34,Dublin 15,Leinster
478,2022-10-26," 36 Forgehill Green, Stamullin, County Meath ",350000,335000,15000,4.48,34,Meath,Leinster
479,2022-10-26," Type E, River Meadows, Cloughduv, Cork ",445000,430000,15000,3.49,34,Cork,Munster
480,2022-10-26," 7 Grove Terrace, Ballyragget, Kilkenny ",155000,175000,-20000,-11.43,34,Kilkenny,Leinster
481,2022-10-26," 60 Grange Hall, Dunshaughlin, Meath ",310000,325000,-15000,-4.62,34,Meath,Leinster
482,2022-10-26," 4 Avondale, Model Farm Road, Cork City ",745000,785000,-40000,-5.1,34,Cork,Munster
483,2022-10-25," Thornfield House,Addinstown,Delvin,Co Westmeath,N91 Y1T9 ",575000,650000,-75000,-11.54,34,Westmeath,Leinster
484,2022-10-25," 10 Ring Terrace, Inchicore, Dublin 8 ",300000,275000,25000,9.09,34,Dublin 8,Leinster
485,2022-10-25," 90 Meridian Court, Ashtown, Dublin 15 ",355000,320000,35000,10.94,34,Dublin 15,Leinster
486,2022-10-25," Sillaheen, Ballymacarbry, Co. Waterford ",800000,1300000,-500000,-38.46,34,Waterford,Munster
487,2022-10-25," 5A The Drumlins, Glenlara, Swellan, Cavan Town, Co. Cavan ",110000,130000,-20000,-15.38,34,Cavan,Ulster
488,2022-10-25," The Bungalow, High Street, Ballyragget, Kilkenny ",145000,175000,-30000,-17.14,34,Kilkenny,Leinster
489,2022-10-25," 38 Dun Uisce, Cahir, Tipperary ",189000,195000,-6000,-3.08,34,Tipperary,Munster
490,2022-10-25," Gurteenroe, Ballydehob, West Cork ",310000,325000,-15000,-4.62,34,Cork,Munster
491,2022-10-25," Apartment 41, Block C, Louisa Park, Station Road, Leixlip, Co. Kildare ",230000,249000,-19000,-7.63,34,Kildare,Leinster
492,2022-10-25," Maree, Oranmore, Co. Galway ",525000,550000,-25000,-4.55,34,Galway,Connaught
493,2022-10-25," Orlando House, Bailieborough, Cavan ",169000,199000,-30000,-15.08,35,Cavan,Ulster
494,2022-10-25," 19 Lower Hartstonge Street, Limerick City, Co. Limerick ",195000,225000,-30000,-13.33,35,Limerick,Munster
495,2022-10-25," Calverstown, Calverstown, Kildare ",375000,425000,-50000,-11.76,35,Kildare,Leinster
496,2022-10-25," Licensed Premises & Investment Property, Kilcullen, Kildare ",595000,690000,-95000,-13.77,35,Kildare,Leinster
497,2022-10-25," Residential Licensed Premises & Investment Property, Calverstown, Kilcullen, Kildare ",595000,690000,-95000,-13.77,35,Kildare,Leinster
499,2022-10-25," Manderlay,Crosstown,Wexford Town,Co Wexford,Y35 EK5H ",975000,1250000,-275000,-22.0,35,Wexford,Leinster
500,2022-10-25," Carrig Linn, Sliabh Amharc, Milehouse Road, Enniscorthy, Co. Wexford, Enniscorthy, Wexford ",365000,395000,-30000,-7.59,35,Wexford,Leinster
501,2022-10-25," Knockainey, Hospital, Co. Limerick ",99000,140000,-41000,-29.29,35,Limerick,Munster
502,2022-10-25," No.4 Crannog, Keshcarrigan, Co Leitrim N41 YY31 ",120000,125000,-5000,-4.0,35,Leitrim,Connaught
503,2022-10-25," 5 The Anchorage, Wicklow Town, Wicklow ",180000,190000,-10000,-5.26,35,Wicklow,Leinster
504,2022-10-25," Coolagh, Castlegar, Co. Galway ",1200000,1500000,-300000,-20.0,35,Galway,Connaught
505,2022-10-25," 13 The Forge, Ballygologue Road, Listowel, Kerry ",235000,249000,-14000,-5.62,35,Kerry,Munster
506,2022-10-25," 43A Woodford Drive, Clondalkin,   Dublin 22 ",375000,395000,-20000,-5.06,35,Dublin 22,Leinster
507,2022-10-25," The Hill, Abbeyfeale, Limerick ",340000,375000,-35000,-9.33,35,Limerick,Munster
508,2022-10-25," Glasealy , Ballitore, Kildare ",275000,295000,-20000,-6.78,36,Kildare,Leinster
509,2022-10-25," 446 North Circular Road, North Circular Road, Dublin 1 ",290000,299950,-9950,-3.32,36,Dublin 1,Leinster
510,2022-10-25," 54 An Choill Rua, Paulstown, Kilkenny ",230000,247000,-17000,-6.88,36,Kilkenny,Leinster
511,2022-10-25," Coolagarry, Walsh Island Near, Portarlington, Laois ",285000,290000,-5000,-1.72,36,Laois,Leinster
513,2022-10-25," Baytown Lodge, Baytown, The Ward, Meath ",520000,485000,35000,7.22,36,Meath,Leinster
514,2022-10-25," 51 The Sycamores, Kilkenny, Kilkenny ",268000,285000,-17000,-5.96,36,Kilkenny,Leinster
515,2022-10-24," Meelick,Portlaoise,Co. Laois,R32RH2F ",199000,225000,-26000,-11.56,36,Laois,Leinster
516,2022-10-24," No. 8 Rahilly Street, Cobh, Co Cork , Cobh, East Cork ",290000,305000,-15000,-4.92,36,Cork,Munster
517,2022-10-24," 23, Shenick Drive, Skerries, County Dublin ",550000,585000,-35000,-5.98,36,Dublin,Leinster
518,2022-10-24," Sky Road, Clifden, Galway ",499500,525000,-25500,-4.86,36,Galway,Connaught
519,2022-10-24," Rusheeny, Oughterard, Galway ",175000,195000,-20000,-10.26,36,Galway,Connaught
521,2022-10-24," Killeenrevagh, Garrymore, Co. Mayo ",525000,550000,-25000,-4.55,36,Mayo,Connaught
522,2022-10-24," 12 St Brigids Terrace, Blackwater, Co. Wexford ",190000,200000,-10000,-5.0,37,Wexford,Leinster
524,2022-10-24," 10 Millrace, Martin's Row, Chapelizod, Dublin 20 ",290000,275000,15000,5.45,37,Dublin 20,Leinster
525,2022-10-24," 199 The Glen, Kilnacourt Woods, Portarlington, Co. Laois ",220000,209500,10500,5.01,37,Laois,Leinster
526,2022-10-24," Apartment Killeen Hall, Ballyfermot, Ballyfermot, Dublin 10 ",238000,245000,-7000,-2.86,37,Dublin 10,Leinster
527,2022-10-24," 19 Father Matthew Road, Turners Cross, Cork City ",225000,250000,-25000,-10.0,37,Cork,Munster
528,2022-10-24," 46 Manorview Park, Letterkenny, Donegal ",159000,149000,10000,6.71,37,Donegal,Ulster
529,2022-10-24," 'Portiuncula', Seamount, Courtown, Wexford ",270000,250000,20000,8.0,37,Wexford,Leinster
530,2022-10-24," 20 Saint Alphonsus Road, Waterford City, Waterford ",160000,170000,-10000,-5.88,37,Waterford,Munster
531,2022-10-24," Fatima Park, Dundalk, Louth ",165000,179000,-14000,-7.82,37,Louth,Leinster
532,2022-10-24," Ballinatray Upper, Ardamine, Wexford ",229000,249000,-20000,-8.03,37,Wexford,Leinster
533,2022-10-24," Arlington Dry Cleaners, Main Street, Portarlington, Laois ",220000,230000,-10000,-4.35,37,Laois,Leinster
534,2022-10-24," 52 Castlewood Gardens, Carlow Town, Carlow ",249000,255000,-6000,-2.35,38,Carlow,Leinster
535,2022-10-24," Moyard, Connemara, Galway ",295000,325000,-30000,-9.23,38,Galway,Connaught
536,2022-10-24," 93 Galtrim Grange, Malahide, Dublin ",295000,300000,-5000,-1.67,38,Dublin,Leinster
537,2022-10-24," Birmingham Road, Tuam, Galway ",240000,250000,-10000,-4.0,38,Galway,Connaught
538,2022-10-24," 37 The Close Downshire Park, Blessington, Co. Wicklow, Blessington, Wicklow ",199500,208000,-8500,-4.09,38,Wicklow,Leinster
539,2022-10-24," 12 Castle View, Ballymacoda, Cork ",240000,260000,-20000,-7.69,38,Cork,Munster
540,2022-10-23," 14 Hollow Close,Oakview Village,Tralee,Co. Kerry,V92 V3HF ",245000,235000,10000,4.26,38,Kerry,Munster
541,2022-10-23," Calcar,Majors Well Road,Longford,N39 E3V5 ",350000,312500,37500,12.0,38,Longford,Leinster
542,2022-10-22," 78 Grahams Court, Wicklow Town, Wicklow ",368000,380000,-12000,-3.16,38,Wicklow,Leinster
543,2022-10-22," 35 Hazelwood,Ballivor,Co Meath,C15 YOR6 ",250000,270000,-20000,-7.41,38,Meath,Leinster
545,2022-10-22," 13 Heather Drive,Rathfarnham,Dublin,D16 WV61 ",499000,525000,-26000,-4.95,38,Dublin,Leinster
546,2022-10-22," Derrilla,Tydavnet,Co. Monaghan ",30000,25000,5000,20.0,38,Monaghan,Ulster
547,2022-10-21," 12 College Green,Maynooth,Co Kildare,W23 A2K0 ",315000,325000,-10000,-3.08,38,Kildare,Leinster
548,2022-10-21," 58a Feale Drive, Listowel, Co. Kerry ",70000,100000,-30000,-30.0,38,Kerry,Munster
549,2022-10-21," Tallaghanrock, Ballaghaderreen, Co. Roscommon ",190000,169000,21000,12.43,38,Roscommon,Connaught
550,2022-10-21," Apartment 5, Le Hunt House, Brennanstown Square, Cabinteely, Dublin 18 ",385000,395000,-10000,-2.53,39,Dublin 18,Leinster
551,2022-10-21," Colomane West,Bantry,Co Cork,P75 XK12 ",345000,375000,-30000,-8.0,39,Cork,Munster
552,2022-10-21," Golden Grove, Roscrea, Co. Tipperary ",375000,395000,-20000,-5.06,39,Tipperary,Munster
554,2022-10-21," 39 An Feadan, Cul Ard, Carrigtwohill, Cork ",235000,245000,-10000,-4.08,39,Cork,Munster
555,2022-10-21," 51 Saint Helens Road, Booterstown, County Dublin ",1250000,1350000,-100000,-7.41,39,Dublin,Leinster
556,2022-10-21," 18 Millbank, Sallins, Kildare ",210000,204000,6000,2.94,39,Kildare,Leinster
557,2022-10-21," Malahide Road, Swords, County Dublin ",195000,130000,65000,50.0,39,Dublin,Leinster
558,2022-10-21," Currabaha, Colligan, Dungarvan, Co. Waterford ",100000,95000,5000,5.26,39,Waterford,Munster
560,2022-10-21," School Lane, Dunleer, Louth ",235000,249000,-14000,-5.62,39,Louth,Leinster
561,2022-10-21," 3 Windsor Road, Rathmines, Dublin 6 ",1595000,1650000,-55000,-3.33,39,Dublin 6,Leinster
562,2022-10-21," Gates, Old Parish, Dungarvan, Waterford ",410000,450000,-40000,-8.89,39,Waterford,Munster
563,2022-10-21," 97 Meadowbrook, Tramore, Waterford ",309000,325000,-16000,-4.92,39,Waterford,Munster
564,2022-10-21," 48A Ardeevin Avenue, Lucan, Co. Dublin ",725000,695000,30000,4.32,39,Dublin,Leinster
565,2022-10-21," Graigue Hartford, Kilmanagh, Kilkenny ",325000,360000,-35000,-9.72,40,Kilkenny,Leinster
566,2022-10-21," Millbrook Road, Oldcastle, co Meath  A82C798 ",340000,380000,-40000,-10.53,40,Meath,Leinster
567,2022-10-21," The Swan Inn, The Swan, Crettyard, Laois ",285000,335000,-50000,-14.93,40,Laois,Leinster
568,2022-10-21," Ballyboy, Ferns, Wexford ",215000,230000,-15000,-6.52,40,Wexford,Leinster
569,2022-10-21," 167 The Anchorage, Seabourne View, Greystones, Wicklow ",280000,295000,-15000,-5.08,40,Wicklow,Leinster
571,2022-10-21," 53 Kenilworth Square, Rathgar, Dublin 6 ",1950000,2250000,-300000,-13.33,40,Dublin 6,Leinster
572,2022-10-21," St Annes, Elm Park, Ennis Road, Co. Limerick ",260000,300000,-40000,-13.33,40,Limerick,Munster
573,2022-10-21," 21 Belvidere Road, North City Centre, Dublin 1 ",750000,815000,-65000,-7.98,40,Dublin 1,Leinster
575,2022-10-21," 11 Coislinne,Gorey,Co. Wexford,Y25PY74 ",229000,250000,-21000,-8.4,40,Wexford,Leinster
576,2022-10-21," 16 Upper John Street,Wexford,Y35 HW26 ",175000,199000,-24000,-12.06,40,Wexford,Leinster
578,2022-10-21," 38 Cromwellsfort Grove,Mulgannon,Wexford,Y35V3Y9 ",249500,239500,10000,4.18,40,Wexford,Leinster
579,2022-10-21," Greenlake,Forth Mountain,Co. Wexford,Y35 T1F2 ",374000,405000,-31000,-7.65,40,Wexford,Leinster
580,2022-10-20," Athlumney,Navan,Co Meath,C15 TDH3 ",595000,650000,-55000,-8.46,40,Meath,Leinster
581,2022-10-20," Rath More Green,Barrack Green,Kinsale,Co. Cork ",430000,425000,5000,1.18,40,Cork,Munster
582,2022-10-20," 11 Upper Main Street, Ballyhaunis, Mayo ",150000,165000,-15000,-9.09,41,Mayo,Connaught
583,2022-10-20," Kilberry, Navan, Co. Meath ",450000,475000,-25000,-5.26,41,Meath,Leinster
584,2022-10-20," 13 Ryebridge Green, Kilcock, Co. Kildare ",395000,415000,-20000,-4.82,41,Kildare,Leinster
585,2022-10-20," Clarinda Park House, Clarinda Park West, Dun Laoghaire, Dublin ",445000,470000,-25000,-5.32,41,Dublin,Leinster
586,2022-10-20," 14 Westpark House, Chapelizod, Dublin 20 ",270000,245000,25000,10.2,41,Dublin 20,Leinster
587,2022-10-20," 7 Jubilee Terrace, Cavan, Cavan ",89000,99000,-10000,-10.1,41,Cavan,Ulster
588,2022-10-20," Glenamaddy, Glenamaddy, Galway ",110000,109000,1000,0.92,41,Galway,Connaught
589,2022-10-20," 52 Austin Friars , Mullingar, Westmeath, N91 WA06 ",210000,195000,15000,7.69,41,Westmeath,Leinster
590,2022-10-20," Gortakileen Oola, Oola, Limerick ",165000,145000,20000,13.79,41,Limerick,Munster
591,2022-10-20," Shraheen, Foxford, Mayo ",299000,315000,-16000,-5.08,41,Mayo,Connaught
592,2022-10-20," Ballagh, Newtownforbes, Co. Longford ",200000,235000,-35000,-14.89,41,Longford,Leinster
593,2022-10-20," 61 Redbarn Cottages , Youghal, Cork ",210000,200000,10000,5.0,41,Cork,Munster
594,2022-10-20," No 12 Ardkeen, Cavan, Cavan ",185000,175000,10000,5.71,41,Cavan,Ulster
595,2022-10-20," 90 Altan, Western Distributor Road, Knocknacarra, Galway City ",210000,170000,40000,23.53,41,Galway,Connaught
596,2022-10-20," 27 Church Hills Road, Coosan, Athlone, Co. Westmeath ",249000,265000,-16000,-6.04,41,Westmeath,Leinster
597,2022-10-20," 29 River Walk, Gort, Galway ",220000,235000,-15000,-6.38,41,Galway,Connaught
598,2022-10-20," Ard Na Mara, Cregboy, Kinvara, Galway ",750000,849000,-99000,-11.66,41,Galway,Connaught
599,2022-10-20," 8 Galtrim Grange, Malahide, Dublin ",500000,540000,-40000,-7.41,41,Dublin,Leinster
600,2022-10-20," Lydican Claregalway, Claregalway, Co. Galway ",70000,85000,-15000,-17.65,42,Galway,Connaught
601,2022-10-20," Lissarulla, Claregalway, Co. Galway ",70000,80000,-10000,-12.5,42,Galway,Connaught
602,2022-10-20," 16 Leeson Park Avenue, Ranelagh, Dublin 6 ",1650000,2100000,-450000,-21.43,42,Dublin 6,Leinster
603,2022-10-20," Ayle,Killawalla,Westport,Co Mayo,F28 VN81 ",249000,269000,-20000,-7.43,42,Mayo,Connaught
604,2022-10-20," 17 Beechwood,Clonbalt Wood,Longford,N39 Y6K8 ",200000,220000,-20000,-9.09,42,Longford,Leinster
605,2022-10-19," 13 Melitta Park,Kildare Town,Co. Kildare,R51 HN77 ",325000,335000,-10000,-2.99,42,Kildare,Leinster
606,2022-10-19," 1 Dunbur Terrace, Wicklow Town, Wicklow ",450000,395000,55000,13.92,42,Wicklow,Leinster
607,2022-10-19," Beechwood Close, Bagenalstown, Co. Carlow ",285000,299950,-14950,-4.98,42,Carlow,Leinster
608,2022-10-19," 13 Dodder Park Road, Rathfarnham, Dublin 14 ",550000,625000,-75000,-12.0,42,Dublin 14,Leinster
609,2022-10-19," Carrueragh,Kilmorna,Co. Kerry,V31 R262 ",29000,27810,1190,4.28,42,Kerry,Munster
610,2022-10-19," 6 Wolverton Glen, Castlepark Road, Dalkey, Co. Dublin ",625000,675000,-50000,-7.41,42,Dublin,Leinster
612,2022-10-19," 'Charnwood', Park Avenue, Dalysfort Road, Salthill, Co. Galway ",1000000,950000,50000,5.26,42,Galway,Connaught
613,2022-10-19," 4 Wilford Court, Bray, Wicklow ",379000,389000,-10000,-2.57,42,Wicklow,Leinster
614,2022-10-19," 62 Lower Churchtown Road, Churchtown, Dublin 14 ",498000,550000,-52000,-9.45,42,Dublin 14,Leinster
616,2022-10-19," 66 Assumption Park, Roscrea, Co. Tipperary ",160000,170000,-10000,-5.88,43,Tipperary,Munster
618,2022-10-19," Apt 406 An Ri Rua, Bettystown, Meath ",275000,295000,-20000,-6.78,43,Meath,Leinster
619,2022-10-19," 87 Fosters Avenue, Mount Merrion, County Dublin ",1295000,1400000,-105000,-7.5,43,Dublin,Leinster
620,2022-10-19," 39 Yeats Heights, Sligo City, Sligo ",195000,175000,20000,11.43,43,Sligo,Connaught
621,2022-10-19," 188 The Island, Chapelizod, Dublin 20 ",265000,275000,-10000,-3.64,43,Dublin 20,Leinster
623,2022-10-19," 140 Meadow Gate, Knockmullen, Gorey, Wexford ",325000,335000,-10000,-2.99,43,Wexford,Leinster
624,2022-10-19," Two Mile House , Naas, Kildare ",199000,205000,-6000,-2.93,43,Kildare,Leinster
625,2022-10-19," Sillot Hill, Kilcullen, Kildare ",199000,205000,-6000,-2.93,43,Kildare,Leinster
626,2022-10-19," Glaslacken, Bunclody, Co. Wexford ",350000,375000,-25000,-6.67,43,Wexford,Leinster
627,2022-10-19," 34 Oakwood Avenue, Swords, County Dublin ",325000,350000,-25000,-7.14,43,Dublin,Leinster
628,2022-10-19," Ardoughan woods, Ballina, Mayo ",400000,305500,94500,30.93,43,Mayo,Connaught
630,2022-10-19," Cragreagh, Killeeneenmore, Craughwell, Galway ",375000,395000,-20000,-5.06,44,Galway,Connaught
631,2022-10-19," 1 Abbey Court,Killala Road,Ballina,Co Mayo,F26 Y8H1 ",229000,249000,-20000,-8.03,44,Mayo,Connaught
632,2022-10-19," 68 Blackwood Avenue,The Gallops,Latt,Cavan,H12 FF65 ",165000,180000,-15000,-8.33,44,Cavan,Ulster
633,2022-10-19," 91 Pineridge,Wexford,Y35 A3N2 ",299000,325000,-26000,-8.0,44,Wexford,Leinster
634,2022-10-19," Castlebar Road,Westport,Co Mayo,F28PP83 ",349000,365000,-16000,-4.38,44,Mayo,Connaught
635,2022-10-19," Castlebar Road,Westport,Co Mayo,F28 D522 ",279000,299000,-20000,-6.69,44,Mayo,Connaught
636,2022-10-19," Castle View,Castle Lane,Tullow,Co. Carlow,R93 Y891 ",275000,285000,-10000,-3.51,44,Carlow,Leinster
637,2022-10-19," 7 Cilldara,Oakpark,Tralee,Co. Kerry,V92 X2ET ",220000,240000,-20000,-8.33,44,Kerry,Munster
638,2022-10-19," 10 Ard Glas,Ballyvora,Ferbane,Co Offaly,R42DN80 ",210000,200000,10000,5.0,44,Offaly,Leinster
639,2022-10-18," 9 Limerick St,Roscrea,Co Tipperary,E53 AE44 ",133000,139000,-6000,-4.32,44,Tipperary,Munster
640,2022-10-18," 35 The Waterways, Sallins, Co. Kildare ",220000,230000,-10000,-4.35,44,Kildare,Leinster
641,2022-10-18," 24a Cois Baile, Dromin, Listowel, Co. Kerry ",125000,140000,-15000,-10.71,44,Kerry,Munster
642,2022-10-18," 37 Bluebell Woods, Oranmore, Galway ",315000,335000,-20000,-5.97,44,Galway,Connaught
643,2022-10-18," 9 Merrymeeting Shopping Centre, Rathnew, Co. Wicklow ",295000,285000,10000,3.51,44,Wicklow,Leinster
644,2022-10-18," Rossminogue, Craanford, Wexford ",95000,110000,-15000,-13.64,44,Wexford,Leinster
645,2022-10-18," 296 Kylemore Road, Ballyfermot,   Dublin 10 ",280000,290000,-10000,-3.45,44,Dublin 10,Leinster
646,2022-10-18," 23 Harbour Court,Arklow,Co Wicklow,Y14EF82 ",350000,375000,-25000,-6.67,45,Wicklow,Leinster
647,2022-10-18," No. 20 Moneen , Castlebar, Mayo ",207000,210000,-3000,-1.43,45,Mayo,Connaught
648,2022-10-18," The Rise, 22 Skerries Rock, Skerries, Co. Dublin ",425000,450000,-25000,-5.56,45,Dublin,Leinster
649,2022-10-18," Painestown, Dublin Road, Drogheda, Meath ",600000,625000,-25000,-4.0,45,Meath,Leinster
650,2022-10-18," 12 Butler Court, Cahir, Tipperary ",425000,450000,-25000,-5.56,45,Tipperary,Munster
651,2022-10-18," No.5 The Orchards, Ashbourne Avenue, South Circular Road, Limerick City ",250000,265000,-15000,-5.66,45,Limerick,Munster
652,2022-10-18," Allen, Kilmeague, Naas, Naas, Kildare ",595000,640000,-45000,-7.03,45,Kildare,Leinster
653,2022-10-18," Commons Lane, Navan, Co. Meath, Navan, Meath ",525000,495000,30000,6.06,45,Meath,Leinster
654,2022-10-18," 29 Annesley Bridge Road, Fairview, Dublin 3 ",199000,250000,-51000,-20.4,45,Dublin 3,Leinster
655,2022-10-18," 3 The Station House, The Weir View, Kilkenny, Kilkenny ",255000,270000,-15000,-5.56,45,Kilkenny,Leinster
656,2022-10-18," West End, Newmarket, Cork ",180000,169000,11000,6.51,45,Cork,Munster
657,2022-10-18," Feohanagh, Ballydavid, Kerry ",250000,275000,-25000,-9.09,45,Kerry,Munster
658,2022-10-18," 20 Grosvenor Place, Rathmines,   Dublin 6 ",995000,1250000,-255000,-20.4,45,Dublin 6,Leinster
659,2022-10-18," Windlawn, Bray Road, Cabinteely, Dublin 18 ",665000,695000,-30000,-4.32,45,Dublin 18,Leinster
660,2022-10-18," Cedar Brook Way, Dublin 10, Dublin ",215000,210000,5000,2.38,45,Dublin,Leinster
662,2022-10-18," c. 30 Acres at Blackberry Lane , Newbridge, Kildare ",360000,380000,-20000,-5.26,46,Kildare,Leinster
664,2022-10-18," 24 The Willows, Millers Brook,, Nenagh, Tipperary ",210000,214000,-4000,-1.87,46,Tipperary,Munster
665,2022-10-18," 26 Clonrooske Abbey, Portlaoise, Laois ",245000,230000,15000,6.52,46,Laois,Leinster
666,2022-10-18," Traighenna Bay Glamping Units, Lettermacaward, Donegal ",299950,349950,-50000,-14.29,46,Donegal,Ulster
667,2022-10-18," 32 Bailis Manor, Athlumney, Navan, Meath ",425000,415000,10000,2.41,46,Meath,Leinster
668,2022-10-18," 37 Ferrybank,Arklow,Co. Wicklow,Y14CF65 ",400000,449000,-49000,-10.91,46,Wicklow,Leinster
669,2022-10-18," 13 Aherlow Woods,Tipperary,Co Tipperary,E34WR64 ",160000,139000,21000,15.11,46,Tipperary,Munster
670,2022-10-18," 1 & 2 Dominick St. & 1 Church St.,Sligo,F91YY6T ",349000,380000,-31000,-8.16,46,Sligo,Connaught
671,2022-10-17," 54 Oakleigh Wood, Dooradoyle, Co. Limerick ",195000,215000,-20000,-9.3,46,Limerick,Munster
672,2022-10-17," 109 Clochran,Kilcloghans,Tuam,Co. Galway,H54 KW35 ",195000,199000,-4000,-2.01,46,Galway,Connaught
673,2022-10-17," 3 Brack Luin, Kingscourt, Cavan ",550000,599000,-49000,-8.18,46,Cavan,Ulster
674,2022-10-17," Parkroe, Glenamaddy, Galway ",149000,159000,-10000,-6.29,46,Galway,Connaught
675,2022-10-17," 3 Riverwalk, Batchelors Walk, Wicklow Town, Wicklow ",335000,365000,-30000,-8.22,46,Wicklow,Leinster
676,2022-10-17," 61, Kellys Bay Pier, Skerries, County Dublin ",460000,475000,-15000,-3.16,46,Dublin,Leinster
677,2022-10-17," 6 The Elms, Crinken Glen, Shankill, Dublin 18 ",450000,495000,-45000,-9.09,47,Dublin 18,Leinster
678,2022-10-17," 73 Tyrconnell Road, Inchicore, Dublin 8 ",595000,495000,100000,20.2,47,Dublin 8,Leinster
679,2022-10-17," No 23 The Willows, Ballinamore, Co. Leitrim N41 PE06 ",175000,170000,5000,2.94,47,Leitrim,Connaught
680,2022-10-17," 43 Templemichael Glebe, Longford, Longford ",325000,339000,-14000,-4.13,47,Longford,Leinster
681,2022-10-17," 141 Blackwater Heights, Navan, Meath ",265000,280000,-15000,-5.36,47,Meath,Leinster
682,2022-10-17," Bealad, Clonakilty,   West Cork ",60000,75000,-15000,-20.0,47,Cork,Munster
683,2022-10-17," 47 The Square Riverbank, Drogheda, Louth ",185000,195000,-10000,-5.13,47,Louth,Leinster
684,2022-10-17," 92 Galtymore Road, Drimnagh, Dublin 12 ",350000,295000,55000,18.64,47,Dublin 12,Leinster
685,2022-10-17," 16 Woodlands Rise, Arklow, Wicklow ",245000,259000,-14000,-5.41,47,Wicklow,Leinster
686,2022-10-17," 97 Francis Street, South City Centre, Dublin 8 ",585000,595000,-10000,-1.68,47,Dublin 8,Leinster
687,2022-10-17," 7 Rose Lawn, Rose Hill, Kilkenny, Kilkenny ",399500,435000,-35500,-8.16,47,Kilkenny,Leinster
688,2022-10-17," 6 Waterside, Rosbercon, New Ross, Co. Wexford ",99000,110000,-11000,-10.0,47,Wexford,Leinster
689,2022-10-17," 18 Oatfield Park, Clane, Kildare ",315000,310000,5000,1.61,48,Kildare,Leinster
690,2022-10-17," 5 Churchlands, Slane, Meath ",205000,220000,-15000,-6.82,48,Meath,Leinster
691,2022-10-17," 7 Woodlands Drive, Arklow, Wicklow ",225000,235000,-10000,-4.26,48,Wicklow,Leinster
692,2022-10-17," 55 Clonard Street, Balbriggan, Dublin ",245000,265000,-20000,-7.55,48,Dublin,Leinster
693,2022-10-17," Labane, Ardrahan, Galway ",30000,25000,5000,20.0,48,Galway,Connaught
695,2022-10-17," 12 Seminary Road, Off Watercourse Road, Co. Cork ",140000,160000,-20000,-12.5,48,Cork,Munster
696,2022-10-17," Tawnagh West, Kinvara, Galway ",65000,85000,-20000,-23.53,48,Galway,Connaught
697,2022-10-17," 33 Holywell Lane, Swords, Dublin ",299000,315000,-16000,-5.08,48,Dublin,Leinster
698,2022-10-17," 1 Dun Coran, Youghal, Cork ",300000,330000,-30000,-9.09,48,Cork,Munster
699,2022-10-17," 73 Ramleh Park, Milltown, Dublin 6 ",1100000,1250000,-150000,-12.0,48,Dublin 6,Leinster
700,2022-10-17," 12 Ardan, Trim Road, Athboy, Meath ",220000,225000,-5000,-2.22,48,Meath,Leinster
701,2022-10-15," 11 Saggart Lodge Court, Citywest, Saggart, Dublin ",345000,349950,-4950,-1.41,48,Dublin,Leinster
702,2022-10-15," 20 River View, Main Street, Ballinasloe, Co. Galway ",150000,130000,20000,15.38,48,Galway,Connaught
703,2022-10-15," 40 Belmayne Park South, Belmayne, Dublin 13 ",365000,380000,-15000,-3.95,48,Dublin 13,Leinster
704,2022-10-15," 13 Dunamaise Court, Dublin Rd, Portlaoise, Laois ",165000,170000,-5000,-2.94,48,Laois,Leinster
705,2022-10-15," 130 Carysfort Park, Blackrock, Co. Dublin ",795000,875000,-80000,-9.14,48,Dublin,Leinster
706,2022-10-15," 3 Broomhall Avenue,Rathnew,Co Wicklow,A67 HP08 ",495000,525000,-30000,-5.71,49,Wicklow,Leinster
707,2022-10-15," Villa Maria,Coolnahiley,Tullamore,Co Offaly,R35V210 ",264000,270000,-6000,-2.22,49,Offaly,Leinster
708,2022-10-14," 17 Slí Na Sruthan, Ballinlough, Co. Roscommon ",100000,110000,-10000,-9.09,49,Roscommon,Connaught
709,2022-10-14," Miltown, Bruff, Co. Limerick ",325000,349000,-24000,-6.88,49,Limerick,Munster
710,2022-10-14," Knockduff,Ballindaggan,Enniscorthy,Co Wexford,Y21Y8N9 ",225000,250000,-25000,-10.0,49,Wexford,Leinster
711,2022-10-14," Dunanore,Enniscorthy,Co. Wexford,Y21 F8Y8 ",275000,295000,-20000,-6.78,49,Wexford,Leinster
712,2022-10-14," 76 Cul Rua,Aglish,Co Waterford,P51K2E2 ",189000,195000,-6000,-3.08,49,Waterford,Munster
713,2022-10-14," 13F Slatt Lower,The Swan,Athy,Co Kildare,R14 DR92 ",169950,179950,-10000,-5.56,49,Kildare,Leinster
714,2022-10-14," Ervallagh, Roundstone, Galway ",600000,650000,-50000,-7.69,49,Galway,Connaught
715,2022-10-14," 16 William Street,Athy,Co. Kildare ",169950,165000,4950,3.0,49,Kildare,Leinster
716,2022-10-14," 22 Sli An Aifrinn,Athlone,Co. Westmeath,N37 KD62 ",295000,325000,-30000,-9.23,49,Westmeath,Leinster
717,2022-10-14," 34 South Street,New Ross,Co. Wexford,Y34 F625 ",245000,275000,-30000,-10.91,49,Wexford,Leinster
718,2022-10-14," 5 Eastham Court, Bettystown, Meath ",220000,249950,-29950,-11.98,49,Meath,Leinster
719,2022-10-14," 14 Rockview Drive, Mountrath Road, Portlaoise, Laois ",180000,175000,5000,2.86,49,Laois,Leinster
720,2022-10-14," 26 St. Sylvesters Villas, Malahide, Dublin ",795000,695000,100000,14.39,49,Dublin,Leinster
721,2022-10-14," 30 Shrewsbury Wood, Cabinteely, Dublin 18 ",750000,795000,-45000,-5.66,49,Dublin 18,Leinster
723,2022-10-14," 3 Rampart Manor, The Ramparts, Kinsale, Cork ",275000,325000,-50000,-15.38,49,Cork,Munster
724,2022-10-14," No. 8 Fr. Matthew Street, Tipperary Town, Tipperary ",115000,120000,-5000,-4.17,50,Tipperary,Munster
725,2022-10-14," 3 Dara Park, Kildare , Kildare Town, Kildare ",395000,430000,-35000,-8.14,50,Kildare,Leinster
726,2022-10-14," 1 Mourne Lodge, Mourne Road, Drimnagh, Dublin 12 ",424950,399950,25000,6.25,50,Dublin 12,Leinster
727,2022-10-14," 13 Our Lady of Lourdes Park, Ballinlough, Cork ",310000,325000,-15000,-4.62,50,Cork,Munster
728,2022-10-14," Derrockstown, Dunshaughlin, Meath ",495000,520000,-25000,-4.81,50,Meath,Leinster
729,2022-10-14," 54 Convent Court, Delgany, Co. Wicklow ",495000,465000,30000,6.45,50,Wicklow,Leinster
730,2022-10-14," 53 Fitzherbert Court, Navan, Meath ",280000,285000,-5000,-1.75,50,Meath,Leinster
731,2022-10-14," Clowney,Ballyconnell,Co. Cavan,H14 RR80 ",900000,680000,220000,32.35,50,Cavan,Ulster
732,2022-10-14," 40 Stephens Road, Inchicore, Dublin 8 ",445000,395000,50000,12.66,50,Dublin 8,Leinster
733,2022-10-14," 11 Holly Walk,Templers Hall,Waterford,X91 C6DX ",185000,199000,-14000,-7.04,50,Waterford,Munster
734,2022-10-14," 192 Moorefield Park,Newbridge,Co. Kildare,W12 D433 ",345000,352500,-7500,-2.13,50,Kildare,Leinster
735,2022-10-14," 11 Harbour Mill,Davitt's Quay,Dungarvan,Co Waterford,X35XN15 ",179000,195000,-16000,-8.21,50,Waterford,Munster
736,2022-10-14," Peafield, Pike Of Rushall, Castletown, Co. Laois ",280000,275000,5000,1.82,50,Laois,Leinster
737,2022-10-13," 28 Monread Crescent,Naas,Co. Kildare,W91 XVP3 ",369000,380000,-11000,-2.89,51,Kildare,Leinster
738,2022-10-13," Oakfield House,Broadleas Commons,Ballymore Eustace,Co. Kildare,W91 X4X0 ",535000,549500,-14500,-2.64,51,Kildare,Leinster
739,2022-10-13," 158 The Park,Naas,Co. Kildare,W91 DCP2 ",344000,349000,-5000,-1.43,51,Kildare,Leinster
740,2022-10-13," 65 Manor Street, Waterford City, Co. Waterford ",149000,165000,-16000,-9.7,51,Waterford,Munster
741,2022-10-13," 14 Burford Drive, HoneyPark, Dun Laoghaire, Co. Dublin ",995000,1095000,-100000,-9.13,51,Dublin,Leinster
742,2022-10-13," Dromanallig, Ballingeary Village , Macroom, Cork ",155000,170000,-15000,-8.82,51,Cork,Munster
743,2022-10-13," 71 Shingán, Milehouse Road, Enniscorthy, Co. Wexford, Enniscorthy, Wexford ",199500,210000,-10500,-5.0,51,Wexford,Leinster
744,2022-10-13," Apt. 17, O'Hare's Mill, Nicholas Street, Dundalk, Louth ",180000,190000,-10000,-5.26,51,Louth,Leinster
745,2022-10-13," 43 Meadowbank, Bushy Park Road, Terenure, Dublin 6 ",575000,595000,-20000,-3.36,51,Dublin 6,Leinster
746,2022-10-13," 9 Turvey Villas, Donabate, County Dublin ",270000,245000,25000,10.2,51,Dublin,Leinster
747,2022-10-13," 148 The Sweepstakes, Ballsbridge, Dublin 4 ",395000,420000,-25000,-5.95,51,Dublin 4,Leinster
748,2022-10-13," 149 Elm Park , Wilton, Cork ",180000,190000,-10000,-5.26,51,Cork,Munster
749,2022-10-13," Residence at Meenvane, Schull,   West Cork ",875000,890000,-15000,-1.69,51,Cork,Munster
750,2022-10-13," Apt.88, Seamount Apartments, Booterstown, County Dublin ",499000,530000,-31000,-5.85,51,Dublin,Leinster
751,2022-10-13," 17 Delaney Park, Dublin Hill, Cork City ",255000,275000,-20000,-7.27,52,Cork,Munster
752,2022-10-13," 13 Rossmore Drive, Newtownmountkennedy, Wicklow ",420000,435000,-15000,-3.45,52,Wicklow,Leinster
753,2022-10-13," 11 Burnaby Mill, Greystones, Wicklow ",770000,795000,-25000,-3.14,52,Wicklow,Leinster
754,2022-10-13," 54 Maple Drive, Castleknock, Dublin 15 ",390000,415000,-25000,-6.02,52,Dublin 15,Leinster
755,2022-10-13," Main Street, Ballinamore, Co. Leitrim N41 X4C0 ",145000,165000,-20000,-12.12,52,Leitrim,Connaught
756,2022-10-13," Limekiln Cottage,Ennistown,Kilmessan,Co Meath,C15 XY82 ",395000,425000,-30000,-7.06,52,Meath,Leinster
757,2022-10-13," Clareen,Shinrone,Birr Co. Offaly,R42 CN93 ",105000,89000,16000,17.98,52,Offaly,Leinster
758,2022-10-12," 21 Caragh Green, Naas, Kildare ",375000,395000,-20000,-5.06,52,Kildare,Leinster
759,2022-10-12," Bohullion Lower,Burt,Co Donegal,F93 DY09 ",410000,395000,15000,3.8,52,Donegal,Ulster
760,2022-10-12," 89 Dunmanus Road , Cabra, Dublin 7 ",300000,325000,-25000,-7.69,52,Dublin 7,Leinster
761,2022-10-12," 47 The Rise, Inse Bay, Laytown, Meath ",278000,290000,-12000,-4.14,52,Meath,Leinster
762,2022-10-12," 12 Tara Court Square, Navan, Co. Meath ",280000,285000,-5000,-1.75,52,Meath,Leinster
763,2022-10-12," 53 Manorfield, Kinnegad, Westmeath ",240000,259000,-19000,-7.34,53,Westmeath,Leinster
764,2022-10-12," 9 The Fairways, Faithlegg, Waterford ",739000,785000,-46000,-5.86,53,Waterford,Munster
765,2022-10-12," 12 Saint Mary's Terrace, Moore Street, Cappamore, Co. Limerick ",97500,127000,-29500,-23.23,53,Limerick,Munster
767,2022-10-12," Avalon, 5 Shorewood, Ballinakill Downs, Waterford City, Waterford ",455000,470000,-15000,-3.19,53,Waterford,Munster
768,2022-10-12," Apartment 2, Belmont House, Vevay Road, Bray, Wicklow ",275000,289000,-14000,-4.84,53,Wicklow,Leinster
769,2022-10-12," 48 Towerview Avenue, The Steeples, Duleek, Meath ",295000,315000,-20000,-6.35,53,Meath,Leinster
770,2022-10-12," 2 Esker Glebe, Lucan, Co. Dublin ",337000,355000,-18000,-5.07,53,Dublin,Leinster
771,2022-10-12," Mullaghmore, Tallanstown, Louth ",349000,360000,-11000,-3.06,53,Louth,Leinster
772,2022-10-12," 11 The Close, Curragh Grange, Newbridge, Kildare ",300000,330000,-30000,-9.09,53,Kildare,Leinster
774,2022-10-12," Ballinageeragh, Dunhill, Waterford ",349000,375000,-26000,-6.93,53,Waterford,Munster
775,2022-10-12," 33 Carrs Mill, Donabate, Dublin ",499950,540000,-40050,-7.42,54,Dublin,Leinster
776,2022-10-12," Lakeside Cottage, Mullinaveigue, Roundwood, Co. Wicklow ",350000,400000,-50000,-12.5,54,Wicklow,Leinster
777,2022-10-12," 60 Kennelsfort Road, Palmerstown, Dublin 20 ",330000,360000,-30000,-8.33,54,Dublin 20,Leinster
778,2022-10-12," 88 Rathedmond Estate, Sligo City, Sligo ",245000,270000,-25000,-9.26,54,Sligo,Connaught
779,2022-10-12," Portrane Road Donabate, Donabate, Dublin ",625000,645000,-20000,-3.1,54,Dublin,Leinster
780,2022-10-12," Glenealy House,Glenealy,Co. Wicklow,A67 AW71 ",1500000,1600000,-100000,-6.25,54,Wicklow,Leinster
781,2022-10-11," Tinnacross,Ferns,Enniscorthy,Co Wexford,Y21Y512 ",219000,230000,-11000,-4.78,54,Wexford,Leinster
782,2022-10-11," 37-38 Island Road,Enniscorthy,Co. Wexford,Y21 E8X7 ",128000,140000,-12000,-8.57,54,Wexford,Leinster
784,2022-10-11," The Sycamore,Marlmount,Old Dublin Road,Dundalk,Co. Louth ",415000,320000,95000,29.69,54,Louth,Leinster
785,2022-10-11," 34 Cuchulainn Heights, Carlingford, Co. Louth ",295000,310000,-15000,-4.84,54,Louth,Leinster
786,2022-10-11," The Beech,Marlmount,Old Dublin Road,Dundalk,Co. Louth ",360000,280000,80000,28.57,54,Louth,Leinster
787,2022-10-11," The Willow,Marlmount,Old Dublin Road,Dundalk,Co. Louth ",455000,360000,95000,26.39,54,Louth,Leinster
788,2022-10-11," Ballingrane, Dingle, Kerry ",360000,350000,10000,2.86,55,Kerry,Munster
789,2022-10-11," 66 Monaleen Heights, Monaleen, Castletroy, Co. Limerick ",500000,580000,-80000,-13.79,55,Limerick,Munster
790,2022-10-11," 10 Holyrood Park, Ballsbridge, Dublin 4 ",1376646,1450000,-73354,-5.06,55,Dublin 4,Leinster
791,2022-10-11," 20 Gort Na Ri, Gort, Galway ",255000,265000,-10000,-3.77,55,Galway,Connaught
792,2022-10-11," Gerah, Blackwater, Kenmare, Kerry ",250000,280000,-30000,-10.71,55,Kerry,Munster
794,2022-10-11," 31 Millbourne Crescent, Ashbourne, Meath ",285000,265000,20000,7.55,55,Meath,Leinster
795,2022-10-11," 37 Waverly Avenue, Greystones, Co. Wicklow ",725000,760000,-35000,-4.61,55,Wicklow,Leinster
796,2022-10-11," 13 The Rise, Mountain Bay, Arklow, Wicklow ",345000,325000,20000,6.15,55,Wicklow,Leinster
797,2022-10-11," 18 St Joesphs Terrace, Sligo City, Sligo ",170000,179000,-9000,-5.03,55,Sligo,Connaught
798,2022-10-11," Latton, Castleblayney, Co. Monaghan ",40000,45000,-5000,-11.11,55,Monaghan,Ulster
800,2022-10-11," Droim Laith, Collins Lane, Tullamore, Offaly ",239950,245000,-5050,-2.06,55,Offaly,Leinster
801,2022-10-11," Kilmoremoy (Derran Grove), Ballina, Mayo ",65000,75000,-10000,-13.33,55,Mayo,Connaught
802,2022-10-11," Clonoughter, Parteen, Clare ",180000,190000,-10000,-5.26,55,Clare,Munster
803,2022-10-11," 39 Arasain Na Mara, Salthill, Co. Galway ",210000,225000,-15000,-6.67,55,Galway,Connaught
804,2022-10-11," 65 Cluain Ri, Ashbourne, Meath ",215000,210000,5000,2.38,55,Meath,Leinster
805,2022-10-11," Edgewell,Richardstown,Ballyboughal,Co. Dublin,A41 WF67 ",695000,725000,-30000,-4.14,56,Dublin,Leinster
806,2022-10-11," West View, Gurteenroe, Bantry,   West Cork ",395000,350000,45000,12.86,56,Cork,Munster
807,2022-10-11," Dollardstown, Beauparc, Navan, Meath ",460000,475000,-15000,-3.16,56,Meath,Leinster
808,2022-10-11," St Michael St, Tipperary Town, Tipperary ",120000,150000,-30000,-20.0,56,Tipperary,Munster
809,2022-10-11," Sycamore House, Woodlands, Rathangan, Kildare ",349000,370000,-21000,-5.68,56,Kildare,Leinster
810,2022-10-11," 6 Shrewsbury Park, Belturbet, Co. Cavan ",175000,185000,-10000,-5.41,56,Cavan,Ulster
811,2022-10-11," 6 Railway View, Belturbet, Cavan ",175000,195000,-20000,-10.26,56,Cavan,Ulster
812,2022-10-11," 20 Riverside Grove, Newbridge, Kildare ",380000,395000,-15000,-3.8,56,Kildare,Leinster
813,2022-10-11," Apartment 79 Hazelwood, Block E, Millfield, Newbridge, Kildare ",175000,180000,-5000,-2.78,56,Kildare,Leinster
814,2022-10-11," 65 Beechmount, Newbridge, Kildare ",345000,360000,-15000,-4.17,56,Kildare,Leinster
815,2022-10-11," 66 Offington Lawn, Sutton, Dublin 13 ",995000,1100000,-105000,-9.55,56,Dublin 13,Leinster
816,2022-10-11," 1 Stramore, Glendowan, Churchill, Churchill, Donegal ",220000,205000,15000,7.32,56,Donegal,Ulster
817,2022-10-11," 92 Maplewood Avenue, Springfield, Tallaght, Dublin 24 ",275000,289000,-14000,-4.84,56,Dublin 24,Leinster
818,2022-10-11," Fohenagh, Ahascragh, Ballinasloe, Galway ",365000,395000,-30000,-7.59,56,Galway,Connaught
819,2022-10-11," 62 O Connell Street, City Centre (Limerick), Limerick City ",410000,400000,10000,2.5,56,Limerick,Munster
820,2022-10-11," Tinnascart,Buttevant,Co. Cork,P51 KC89 ",165000,150000,15000,10.0,56,Cork,Munster
821,2022-10-10," 79 Creagh Woods,Gorey,Co. Wexford,Y25 D9P4 ",249000,259000,-10000,-3.86,56,Wexford,Leinster
822,2022-10-10," 13 College Court, Portlaoise, Co. Laois ",140000,150000,-10000,-6.67,57,Laois,Leinster
823,2022-10-10," Apartment 3, 38 Church Road, Greystones, Wicklow ",325000,345000,-20000,-5.8,57,Wicklow,Leinster
824,2022-10-10," 227 Seabourne View, Greystones,  Co. Wicklow ",335000,345000,-10000,-2.9,57,Wicklow,Leinster
825,2022-10-10," Poll na bPeist, Moycullen, Galway ",65000,67500,-2500,-3.7,57,Galway,Connaught
827,2022-10-10," Site at 1 St. Brigid's Place, Church Bay, Crosshaven, Cork ",110000,140000,-30000,-21.43,57,Cork,Munster
828,2022-10-10," Killybegs, Inch, Wexford ",300000,190000,110000,57.89,57,Wexford,Leinster
829,2022-10-10," 11 Rutland Grove, Dublin 12, Dublin ",345000,370000,-25000,-6.76,57,Dublin,Leinster
830,2022-10-10," 12 Lakeview Court, Lakeside, Kilkenny, Kilkenny ",210000,200000,10000,5.0,57,Kilkenny,Leinster
831,2022-10-10," Main Street, Ballymore Eustace, Kildare ",169000,195000,-26000,-13.33,57,Kildare,Leinster
832,2022-10-10," 5 Glentaun close, Ballinasloe, Galway ",315000,319500,-4500,-1.41,57,Galway,Connaught
833,2022-10-10," 10 Saint Francis Terrace, Athlone East, Westmeath ",195000,210000,-15000,-7.14,57,Westmeath,Leinster
834,2022-10-10," Seapoint, Balbriggan, County Dublin ",595000,630000,-35000,-5.56,57,Dublin,Leinster
835,2022-10-10," 35 Ard Caher, Louisburgh, Mayo ",310000,320000,-10000,-3.13,57,Mayo,Connaught
836,2022-10-10," Hillbrook Woods, Blanchardstown, Dublin 15 ",260000,270000,-10000,-3.7,57,Dublin 15,Leinster
837,2022-10-10," Main Street, Kildorrery, Cork ",89000,100000,-11000,-11.0,57,Cork,Munster
838,2022-10-10," Adamstown, Mullingar, Westmeath ",154950,144950,10000,6.9,57,Westmeath,Leinster
839,2022-10-10," 28 Great Western Square, Phibsboro, Dublin 7 ",519000,560000,-41000,-7.32,58,Dublin 7,Leinster
840,2022-10-10," 111 Beauvale Park, Beaumont, Dublin ",385000,395000,-10000,-2.53,58,Dublin,Leinster
841,2022-10-10," 37 Pinewood, Elm Park, Wilton, Cork City ",265000,270000,-5000,-1.85,58,Cork,Munster
842,2022-10-10," Craig Ayr Ballynerin, Wicklow Town, Wicklow ",485000,495000,-10000,-2.02,58,Wicklow,Leinster
843,2022-10-10," 64 Moyne Road, Ranelagh, Dublin 6 ",1495000,1575000,-80000,-5.08,58,Dublin 6,Leinster
844,2022-10-09," no. 29 Beechwood court, cluain ard, cobh, co cork, Cobh, East Cork ",280000,290000,-10000,-3.45,58,Cork,Munster
845,2022-10-08," Mullagh More, Ballinasloe, Galway ",165000,185000,-20000,-10.81,58,Galway,Connaught
847,2022-10-08," 206D An Tsean Mhargadh, Greenlanes, Drogheda, Co. Louth ",115000,125000,-10000,-8.0,58,Louth,Leinster
849,2022-10-08," 87-88 Harcourt Street, Dublin 2 ",42000000,52000000,-10000000,-19.23,58,Dublin 2,Leinster
850,2022-10-08," Yellow Walls,Dunderry,Co Meath,C15FD29 ",300000,320000,-20000,-6.25,58,Meath,Leinster
851,2022-10-07," 23 Anglers Walk,Burrin Road,Carlow,R93 XH70 ",225000,229500,-4500,-1.96,59,Carlow,Leinster
852,2022-10-07," 47 Ashfield,Blackbog Road,Carlow,R93 R5C6 ",235000,240000,-5000,-2.08,59,Carlow,Leinster
853,2022-10-07," Cuilmore,Swinford,Co. Mayo,F12 YT61 ",185000,195000,-10000,-5.13,59,Mayo,Connaught
854,2022-10-07," Manorland,Trim,Co Meath,C15 A661 ",295000,350000,-55000,-15.71,59,Meath,Leinster
855,2022-10-07," 51 Riverside, R32, Portarlington, Co. Laois ",210000,222500,-12500,-5.62,59,Laois,Leinster
856,2022-10-07," Farnamurray, Ballygraigue Road, Nenagh, Co. Tipperary ",199950,219950,-20000,-9.09,59,Tipperary,Munster
857,2022-10-07," Sliabh Ban View, Lanesborough, Co.Longford ",90000,160000,-70000,-43.75,59,Longford,Leinster
859,2022-10-07," 17 Upper John Street, Sligo City, Sligo ",95000,85000,10000,11.76,59,Sligo,Connaught
860,2022-10-07," Crosstown, Killarney, Kerry ",350000,375000,-25000,-6.67,59,Kerry,Munster
861,2022-10-07," Land c. 31.3 Acres/12.68 Ha., Ballymana Lane, Kiltipper, Tallaght, Dublin 24 ",285000,295000,-10000,-3.39,59,Dublin 24,Leinster
863,2022-10-07," 33 Kerdiff Close, Naas, Kildare ",355000,380000,-25000,-6.58,59,Kildare,Leinster
864,2022-10-07," 10B Greencastle Drive, Coolock, Dublin 17 ",299500,399500,-100000,-25.03,59,Dublin 17,Leinster
865,2022-10-07," Apt 2 Valley Park Clonattin, Gorey, Wexford ",175000,185000,-10000,-5.41,60,Wexford,Leinster
866,2022-10-07," Bath Street, Waterford City, Co. Waterford ",160000,170000,-10000,-5.88,60,Waterford,Munster
867,2022-10-07," 54 Old Kilmainham Village, Kilmainham, Dublin 8 ",330000,295000,35000,11.86,60,Dublin 8,Leinster
869,2022-10-07," 35 Castleview, Fenit, Tralee, Kerry ",280000,180000,100000,55.56,60,Kerry,Munster
870,2022-10-07," Karuna, Old Village, Rathnew, Wicklow ",495000,535000,-40000,-7.48,60,Wicklow,Leinster
871,2022-10-07," Karuna, The Old VIllage, Rathnew, Co. Wicklow ",495000,535000,-40000,-7.48,60,Wicklow,Leinster
872,2022-10-07," 14 Marian Row, Ballinagh, Cavan ",127500,130000,-2500,-1.92,60,Cavan,Ulster
873,2022-10-07," 8 Priory Drive,Johnstown,Navan,Co Meath,C15 ECC1 ",275000,295000,-20000,-6.78,60,Meath,Leinster
874,2022-10-07," 54 Woodbank, Shankill, Dublin 18 ",525000,545000,-20000,-3.67,60,Dublin 18,Leinster
875,2022-10-07," 6 Ardfrail Close, Oldcastle, Meath ",190000,210000,-20000,-9.52,60,Meath,Leinster
876,2022-10-07," Coolboyoge,Butlersbridge,Co Cavan,H12 RD63 ",420000,400000,20000,5.0,60,Cavan,Ulster
877,2022-10-07," 28 Lios Mor,Newport,Co Mayo,F28 K5N3 ",150000,169000,-19000,-11.24,60,Mayo,Connaught
878,2022-10-07," 25 Lios Mor,Newport,Co Mayo,F28 VX33 ",165000,179000,-14000,-7.82,60,Mayo,Connaught
879,2022-10-07," Bolands Lock,Cappincur,Tullamore,Co Offaly,R35 W940 ",465000,525000,-60000,-11.43,60,Offaly,Leinster
880,2022-10-07," Anam Cara,Cloondacarra Beg,Castlerea,Co. Roscommon,F45Y427 ",340000,375000,-35000,-9.33,60,Roscommon,Connaught
881,2022-10-07," Westwind,Town Wall,New Ross,Co. Wexford,Y34 X031 ",249000,279000,-30000,-10.75,60,Wexford,Leinster
882,2022-10-07," Bohreen Hill,Enniscorthy,Co. Wexford,Y21 E6F6 ",395000,550000,-155000,-28.18,60,Wexford,Leinster
883,2022-10-06," 100 The Village Green,Royal Meadows,Kilcock,Co KIldare,W23 P2C9 ",445000,475000,-30000,-6.32,61,Kildare,Leinster
885,2022-10-06," Meenbanad,Burtonport,Co Donegal ",25000,35000,-10000,-28.57,61,Donegal,Ulster
886,2022-10-06," Alder Cottage,Derrora,Churchill,Co Donegal,F92 NP97 ",160000,175000,-15000,-8.57,61,Donegal,Ulster
887,2022-10-06," 54 Pairc An Oir,Rathcormac,Co. Cork,P61HH02 ",240000,245000,-5000,-2.04,61,Cork,Munster
888,2022-10-06," 3 The Gardens,Irish Street,Enniscorthy,Co Wexford,Y21 T716 ",179000,185000,-6000,-3.24,61,Wexford,Leinster
889,2022-10-06," Brighton Road, 45 Hollybrook, Foxrock, Dublin 18 ",585000,599000,-14000,-2.34,61,Dublin 18,Leinster
890,2022-10-06," 2 Father Mathew Court, Co. Tipperary ",90000,100000,-10000,-10.0,61,Tipperary,Munster
891,2022-10-06," 31 Villa Park Ave Navan Road Dublin 7, Navan Road, Dublin 7 ",520000,540000,-20000,-3.7,61,Dublin 7,Leinster
892,2022-10-06," Humphreystown, Blessington, Wicklow ",585000,595000,-10000,-1.68,61,Wicklow,Leinster
893,2022-10-06," 4 Sunnyside, Ballypatrick, Tipperary ",450000,400000,50000,12.5,61,Tipperary,Munster
894,2022-10-06," 117 Cluain Bui, Quinagh, Carlow Town, Carlow ",235000,250000,-15000,-6.0,61,Carlow,Leinster
895,2022-10-06," 37 Santry Close, Santry, Dublin 9 ",525000,550000,-25000,-4.55,61,Dublin 9,Leinster
896,2022-10-06," 28 Rath Gael, Clondalkin, Dublin 22 ",189000,179000,10000,5.59,61,Dublin 22,Leinster
897,2022-10-06," 2 Breandrum, Ballyconnell, Co. Cavan ",250000,275000,-25000,-9.09,62,Cavan,Ulster
898,2022-10-06," 1 Riverside, Furnaceland, Swanlinbar, Co. Cavan ",199500,205000,-5500,-2.68,62,Cavan,Ulster
899,2022-10-06," 17 Sandymount Green, Sandymount, Dublin 4 ",1750000,1900000,-150000,-7.89,62,Dublin 4,Leinster
900,2022-10-06," 95 Newtown Lawns, Mullingar, Westmeath ",220000,209950,10050,4.79,62,Westmeath,Leinster
901,2022-10-06," 3 Priory Street, New Ross, Wexford ",297500,325000,-27500,-8.46,62,Wexford,Leinster
902,2022-10-06," 2 Railway View, Knocklong, Limerick ",150000,130000,20000,15.38,62,Limerick,Munster
903,2022-10-06," Clohamon, Bunclody, Wexford ",110000,75000,35000,46.67,62,Wexford,Leinster
905,2022-10-06," Brize,Claremorris,Co. Mayo,F12 R611 ",175000,185000,-10000,-5.41,62,Mayo,Connaught
906,2022-10-06," The Lodge, Cronybyrne, Clara Vale, Rathdrum, Wicklow ",465000,495000,-30000,-6.06,62,Wicklow,Leinster
907,2022-10-06," No. 3 St. John's Villas, Waterford City, Waterford ",225000,245000,-20000,-8.16,62,Waterford,Munster
908,2022-10-06," 92 Cromwellsfort Drive,Wexford Town,Y35 A9D6 ",249000,275000,-26000,-9.45,62,Wexford,Leinster
909,2022-10-06," 16 Wolseley Court,Tullow,Co. Carlow,R93 E827 ",290000,299000,-9000,-3.01,62,Carlow,Leinster
910,2022-10-05," Twin Oaks,Gragadder,Kilcock,Co Kildare,W23 EYY0 ",675000,725000,-50000,-6.9,62,Kildare,Leinster
911,2022-10-05," 3 Kilgar, Jocelyn Street, Dundalk, Co. Louth ",158000,160000,-2000,-1.25,63,Louth,Leinster
912,2022-10-05," 15 The Avenue, Orlynn Park, Lusk, Co. Dublin ",320000,350000,-30000,-8.57,63,Dublin,Leinster
913,2022-10-05," The Poplar,Carrabeag,Newport Road,Castlebar,Co. Mayo ",348000,280000,68000,24.29,63,Mayo,Connaught
914,2022-10-05," 31 Harty Place, Portobello, South City Centre, Dublin 8 ",250000,285000,-35000,-12.28,63,Dublin 8,Leinster
915,2022-10-05," Hollywood,Naul,Ballyboughal,Co Dublin,A41 PP79 ",449950,475000,-25050,-5.27,63,Dublin,Leinster
916,2022-10-05," 24 Morrow House, Baldoyle, Dublin 13 ",220000,215000,5000,2.33,63,Dublin 13,Leinster
917,2022-10-05," 49 Foxrock Park , Foxrock, Dublin 18 ",625000,695000,-70000,-10.07,63,Dublin 18,Leinster
918,2022-10-05," 49 Ashbrook, The Moyne, Enniscorthy, Co. Wexford , Enniscorthy, Wexford ",189000,195000,-6000,-3.08,63,Wexford,Leinster
919,2022-10-05," 12 Primrose Street, Phibsboro, Dublin 7 ",445000,475000,-30000,-6.32,63,Dublin 7,Leinster
920,2022-10-05," 5 Grange Manor Road, Rathfarnham, Dublin 16 ",550000,575000,-25000,-4.35,63,Dublin 16,Leinster
921,2022-10-05," Church Road, Kilnaleck, Co. Cavan ",160000,175000,-15000,-8.57,63,Cavan,Ulster
922,2022-10-05," Site 1 Clohamon, Bunclody, Co. Wexford ",110000,75000,35000,46.67,63,Wexford,Leinster
923,2022-10-05," Site 2 Clohamon, Bunclody, Co. Wexford ",110000,75000,35000,46.67,63,Wexford,Leinster
924,2022-10-05," 4 Ardagh Crescent, Blackrock, County Dublin ",649950,699950,-50000,-7.14,63,Dublin,Leinster
925,2022-10-05," Apartment 109 Atkins Hall, Lee Road, Sundays Well, Cork City ",215000,235000,-20000,-8.51,64,Cork,Munster
926,2022-10-05," Apt 330 The Distillery Building, Distillery Road, Drumcondra, Dublin 3 ",295000,310000,-15000,-4.84,64,Dublin 3,Leinster
927,2022-10-05," Abbey Street, Cahir, Tipperary ",165000,130000,35000,26.92,64,Tipperary,Munster
928,2022-10-05," Kilpurcel, Donaghmore, Rathdowney, Laois ",450000,350000,100000,28.57,64,Laois,Leinster
929,2022-10-05," 86 Laurel Grove,Tagoat,Co. Wexford,Y35 A998 ",225000,249000,-24000,-9.64,64,Wexford,Leinster
930,2022-10-04," Sheane, Moanfin, Nenagh, Co. Tipperary ",119950,99950,20000,20.01,64,Tipperary,Munster
932,2022-10-04," Site at Camp Street, Oughterard, Co. Galway ",49000,65000,-16000,-24.62,64,Galway,Connaught
933,2022-10-04," 3 Willow Park,Ennis,Co. Clare.,V95 E8K5 ",190000,195000,-5000,-2.56,64,Clare,Munster
934,2022-10-04," 51 Shingan,Milehouse,Enniscorthy,Co Wexford,Y21XOE3 ",189000,195000,-6000,-3.08,64,Wexford,Leinster
935,2022-10-04," Tomnalossett,Enniscorthy,Co. Wexford.,Y21D2Y0 ",275000,280000,-5000,-1.79,64,Wexford,Leinster
936,2022-10-04," Killina, Ballinakill Upper, Carbury, Co. Kildare ",380000,399000,-19000,-4.76,64,Kildare,Leinster
937,2022-10-04," Derrincullig, Kilgarvan, Kenmare, Kerry ",130000,150000,-20000,-13.33,64,Kerry,Munster
938,2022-10-04," Cloonarragh, Derrane, Co. Roscommon ",75000,95000,-20000,-21.05,64,Roscommon,Connaught
939,2022-10-04," Croaghill, Williamstown, Galway ",165000,175000,-10000,-5.71,64,Galway,Connaught
940,2022-10-04," 6 The Yew, Carysfort Hall, Carysfort Park, Blackrock, County Dublin ",875000,925000,-50000,-5.41,65,Dublin,Leinster
941,2022-10-04," Lus na Greine, Athlone West, Roscommon ",395000,385000,10000,2.6,65,Roscommon,Connaught
943,2022-10-04," Errill, Rathdowney, Laois ",175000,190000,-15000,-7.89,65,Laois,Leinster
944,2022-10-04," 19 Maryfield Court, Naas, Kildare ",260000,250000,10000,4.0,65,Kildare,Leinster
945,2022-10-04," 10 Castlebawn, Kilmeage, Kildare ",259000,280000,-21000,-7.5,65,Kildare,Leinster
946,2022-10-04," 19 Priory Avenue, Eden Gate, Delgany, Wicklow ",975000,995000,-20000,-2.01,65,Wicklow,Leinster
947,2022-10-04," 4 Father Redmond Park, Arklow, Wicklow ",190000,199000,-9000,-4.52,65,Wicklow,Leinster
949,2022-10-04," Lands - Ballyduff, Dungarvan, Waterford ",400000,380000,20000,5.26,65,Waterford,Munster
950,2022-10-04," 63 Priory Wood, Donabate, Dublin ",429950,449950,-20000,-4.44,65,Dublin,Leinster
952,2022-10-04," Site At Furrymelia, Barna, Co. Galway ",265000,295000,-30000,-10.17,66,Galway,Connaught
953,2022-10-04," 29 Springfield Court, Wicklow Town, Wicklow ",275000,295000,-20000,-6.78,66,Wicklow,Leinster
954,2022-10-04," Loretto House, 3 Kickham Street, Thurles, Tipperary ",125000,130000,-5000,-3.85,66,Tipperary,Munster
955,2022-10-04," 11 Power Mews , Faithlegg, Waterford ",139000,120000,19000,15.83,66,Waterford,Munster
956,2022-10-04," 6 Cedar Walk, Cluain Árd, Cobh, Cork ",275000,278000,-3000,-1.08,66,Cork,Munster
957,2022-10-04," Penthouse No. 9 Sand Quay Mill, Clonakilty, West Cork ",195000,200000,-5000,-2.5,66,Cork,Munster
958,2022-10-04," 4 Rathbride Demesne, Kildare Town, Kildare ",285000,300000,-15000,-5.0,66,Kildare,Leinster
959,2022-10-04," Lismaine, Jenkinstown, Kilkenny ",395000,420000,-25000,-5.95,66,Kilkenny,Leinster
960,2022-10-04," 52 The Willows, Hacketstown Rd, Carlow Town, Carlow ",229000,234950,-5950,-2.53,66,Carlow,Leinster
961,2022-10-04," 6 Old Bawn Road, Tallaght,   Dublin 24 ",395000,375000,20000,5.33,66,Dublin 24,Leinster
962,2022-10-04," 13 Wolfe Tone Square Middle, Bray, Wicklow ",365000,385000,-20000,-5.19,66,Wicklow,Leinster
963,2022-10-04," No. 2 surfers Cove, Tullan Strand Rd, Bundoran, Donegal ",258000,250000,8000,3.2,66,Donegal,Ulster
964,2022-10-04," 22, The Close, Ard Patrick, Ladyswell, Cork City, Cork ",325000,305000,20000,6.56,66,Cork,Munster
965,2022-10-04," 15 Ard Patrick Close, Ladys Well, Cork City, Cork ",315000,305000,10000,3.28,66,Cork,Munster
966,2022-10-04," 13 Killadreenan, Newtownmountkennedy, Wicklow ",325000,375000,-50000,-13.33,66,Wicklow,Leinster
968,2022-10-04," 2 Elmwood, Hartstown, Dublin 15 ",315000,320000,-5000,-1.56,67,Dublin 15,Leinster
970,2022-10-04," 99 Latchford Square, Clonee, Dublin 15 ",279950,290000,-10050,-3.47,67,Dublin 15,Leinster
971,2022-10-04," 23 Pinebrook Lawn, Clonsilla, Dublin 15 ",295000,300000,-5000,-1.67,67,Dublin 15,Leinster
972,2022-10-04," 5 Atlantic View Apt, Portnablagh, Donegal ",315000,348000,-33000,-9.48,67,Donegal,Ulster
973,2022-10-04," 10 The Downs, Lakepoint, Mullingar, Westmeath ",135000,129950,5050,3.89,67,Westmeath,Leinster
974,2022-10-04," An Tig Beag,Gilberts Row,Rathdrum,Co Wicklow,A67 VW08 ",195000,225000,-30000,-13.33,67,Wicklow,Leinster
975,2022-10-04," The Bricks,Athboy Road,Ballivor,Co Meath,C15 X221 ",420000,450000,-30000,-6.67,67,Meath,Leinster
976,2022-10-04," Boulera,Knock,Co Tipperary,E53 YK07 ",295000,325000,-30000,-9.23,67,Tipperary,Munster
977,2022-10-04," Casheltauna,Four Mile House,Co. Roscommon,F42 RX22 ",150000,180000,-30000,-16.67,67,Roscommon,Connaught
978,2022-10-04," 94 Bru na hAbhainn,Slane Road,Navan,Co. Meath ",265000,275000,-10000,-3.64,67,Meath,Leinster
979,2022-10-03," 13 Beechwood Lawns, Rathcoole, County Dublin ",450000,325000,125000,38.46,67,Dublin,Leinster
980,2022-10-03," 103 Ashfield East,Old Golf Links Road,Kilkenny,R95 H9V9 ",265000,285000,-20000,-7.02,67,Kilkenny,Leinster
981,2022-10-03," Cocklehill,Blackrock,Co. Louth,A91 A0H4 ",280000,300000,-20000,-6.67,67,Louth,Leinster
982,2022-10-03," 77 Caiseal na Ri,Golden Road,Cashel,Co Tipperary,E25YR63 ",350000,325000,25000,7.69,67,Tipperary,Munster
983,2022-10-03," Derrylaghan, Kilcar, Donegal ",320000,345000,-25000,-7.25,67,Donegal,Ulster
984,2022-10-03," 1 Whitworth Place, Drumcondra, Dublin 3 ",650000,659000,-9000,-1.37,68,Dublin 3,Leinster
985,2022-10-03," Oreen, Ballysimon, Co. Limerick ",229000,250000,-21000,-8.4,68,Limerick,Munster
986,2022-10-03," 11 The Path, Garryowen, Co. Limerick ",170000,175000,-5000,-2.86,68,Limerick,Munster
987,2022-10-03," Shinnagh , Rathmore, Kerry ",180000,190000,-10000,-5.26,68,Kerry,Munster
989,2022-10-03," Approx 1.09 Acres & Cottage,Montevideo Road,(Clybanane),Roscrea,Co Tipperary ",120000,100000,20000,20.0,68,Tipperary,Munster
990,2022-10-03," 4 Shournagh Drive, Blarney, Cork ",429500,450000,-20500,-4.56,68,Cork,Munster
991,2022-10-03," Site D, Tomnaboley, Boolavogue, Gorey, Wexford ",57000,60000,-3000,-5.0,68,Wexford,Leinster
992,2022-10-03," 17 Rosanna Close, Rosanna Road, Tipperary Town, Tipperary ",185000,165000,20000,12.12,68,Tipperary,Munster
993,2022-10-03," Killower, Belclare, Galway ",40000,50000,-10000,-20.0,68,Galway,Connaught
995,2022-10-03," 9 Ballard Road, Miltown Malbay, Clare ",165000,175000,-10000,-5.71,68,Clare,Munster
996,2022-10-03," Millar's Cottage,Tandys Bridge,Naas,Co. Kildare,W91 RWX3 ",750000,900000,-150000,-16.67,68,Kildare,Leinster
997,2022-10-03," 34 Rivervalley Grove, Swords, Dublin ",430000,450000,-20000,-4.44,68,Dublin,Leinster
998,2022-10-03," 14 Swords Street, Stoneybatter, Dublin 7 ",300000,320000,-20000,-6.25,68,Dublin 7,Leinster
1000,2022-10-03," Carhoo, Kildorrery, Cork ",220000,235000,-15000,-6.38,68,Cork,Munster
1001,2022-10-03," 14 Seaview, Poulshone, Gorey, Wexford ",235000,245000,-10000,-4.08,69,Wexford,Leinster
1002,2022-10-03," 16 Cluain Ard,Lis na Dara,Dundalk,Co. Louth,A91 PKD2 ",295000,300000,-5000,-1.67,69,Louth,Leinster
1003,2022-10-03," 11 The Green, Meadowvale, Arklow, Wicklow, Y14H683 ",315000,325000,-10000,-3.08,69,Wicklow,Leinster
1004,2022-10-03," 42 Glebemount, Wicklow Town, Co. Wicklow ",415000,440000,-25000,-5.68,69,Wicklow,Leinster
1006,2022-10-03," West Lands, Long Island, Schull, West Cork ",325000,350000,-25000,-7.14,69,Cork,Munster
1007,2022-10-03," 1 Mahony Square Great William O’Brien Street, Blackpool, Cork ",150000,125000,25000,20.0,69,Cork,Munster
1008,2022-10-03," 7 Carrickmines Dale, Carrickmines Wood, Dublin 18, Dublin ",1295000,1395000,-100000,-7.17,69,Dublin 18,Leinster
1009,2022-10-03," 13 The Weir, Market Point, Patrick Street, Mullingar, Westmeath ",180000,184000,-4000,-2.17,69,Westmeath,Leinster
1011,2022-10-03," 4 Ocean Point, Courtown, Wexford ",180000,187000,-7000,-3.74,69,Wexford,Leinster
1012,2022-10-03," 8 Upper Grattan Park , Greystones, Wicklow ",430000,450000,-20000,-4.44,69,Wicklow,Leinster
1013,2022-10-03," 65 Friars Walk, Ballyphehane, Cork ",150000,170000,-20000,-11.76,69,Cork,Munster
1014,2022-10-03," Caherwisheen, Ballyard, Tralee, Kerry ",585000,695000,-110000,-15.83,69,Kerry,Munster
1015,2022-10-03," 6 Stone Park, Mount Merrion, Dublin ",1100000,1140000,-40000,-3.51,69,Dublin,Leinster
1016,2022-10-01," Clooncugger, Skibbereen, West Cork ",80000,99000,-19000,-19.19,69,Cork,Munster
1017,2022-10-01," 237 Elm Mount Avenue, Beaumont, Dublin 9 ",395000,415000,-20000,-4.82,69,Dublin 9,Leinster
1018,2022-10-01," 4 Abbey Court, A67, Wicklow Town, Co. Wicklow ",330000,325000,5000,1.54,69,Wicklow,Leinster
1019,2022-10-01," 20 Charter House,Dunboyne Road,Maynooth,Co.Kildare,W23 PW28 ",160000,175000,-15000,-8.57,70,Kildare,Leinster
1020,2022-09-30," 10 Chieftains Crescent,Balbriggan,Co Dublin,K32 W297 ",289950,279950,10000,3.57,70,Dublin,Leinster
1021,2022-09-30," 20 Ard an Locha,Moate,Co. Westmeath,N37 YY88 ",269500,275000,-5500,-2.0,70,Westmeath,Leinster
1022,2022-09-30," 12 Rochfort House, Christchurch, Dublin 8 ",285000,225000,60000,26.67,70,Dublin 8,Leinster
1023,2022-09-30," Mascot, Market Street, Ardee, Louth ",110000,135000,-25000,-18.52,70,Louth,Leinster
1024,2022-09-30," 275 Killinarden Estate, Tallaght, Dublin 24 ",285000,315000,-30000,-9.52,71,Dublin 24,Leinster
1025,2022-09-30," 14 Leix Road , Cabra, Dublin 7 ",350000,375000,-25000,-6.67,71,Dublin 7,Leinster
1026,2022-09-30," Ross, Moyard, Galway ",70000,75000,-5000,-6.67,71,Galway,Connaught
1027,2022-09-30," 23 Bellgree Drive, Tyrrelstown, Dublin 15 ",264950,299950,-35000,-11.67,71,Dublin 15,Leinster
1028,2022-09-30," 41 Seaview Park, First Sea Road, Sligo City, Sligo ",175000,190000,-15000,-7.89,71,Sligo,Connaught
1029,2022-09-30," Pound Street, Templetuohy, Thurles, Tipperary ",115000,150000,-35000,-23.33,71,Tipperary,Munster
1030,2022-09-30," Bungalow on c.0.5 Acre / 0.202 Ha., Lodge Lane, Lacken, Wicklow ",595000,649000,-54000,-8.32,71,Wicklow,Leinster
1031,2022-09-30," Terryduff,Bofeenaun,Ballina,Co Mayo,F26 H4X2 ",260000,270000,-10000,-3.7,71,Mayo,Connaught
1033,2022-09-30," 154 Charlesland Park, Greystones, Co.Wicklow ",295000,310000,-15000,-4.84,71,Wicklow,Leinster
1034,2022-09-30," 7 Garrai Coirce, Clybaun Road, Knocknacarra, Galway ",235000,250000,-15000,-6.0,72,Galway,Connaught
1035,2022-09-30," 3 Pattisons Estate, Mountmellick, Laois ",150000,170000,-20000,-11.76,72,Laois,Leinster
1037,2022-09-30," 46 Pinewood Avenue, Glasnevin,   Dublin 11 ",495000,525000,-30000,-5.71,72,Dublin 11,Leinster
1038,2022-09-30," 137 Balreask Manor, Navan, Co. Meath, Navan, Meath ",340000,355000,-15000,-4.23,72,Meath,Leinster
1039,2022-09-30," Monaughrim, Clonegal, Carlow ",270000,280000,-10000,-3.57,72,Carlow,Leinster
1040,2022-09-30," 37 Atlantic Coast , Tramore, Waterford ",185000,180000,5000,2.78,72,Waterford,Munster
1041,2022-09-30," Lecarrow,Charlestown,Co. Mayo,F12 E263 ",175000,165000,10000,6.06,72,Mayo,Connaught
1042,2022-09-30," 20 Rathdrum,Drumalee,Cavan,Co. Cavan,H12 DE43 ",160000,135000,25000,18.52,72,Cavan,Ulster
1043,2022-09-29," 94 Riverside Drive, Red Barns Road, Dundalk, Co. Louth ",210000,215000,-5000,-2.33,72,Louth,Leinster
1044,2022-09-29," Carrownadargny, Co. Sligo, Geevagh ",70000,120000,-50000,-41.67,72,Sligo,Connaught
1046,2022-09-29," 4 Sandfield Gardens, Blackrock, Co. Louth ",325000,380000,-55000,-14.47,72,Louth,Leinster
1047,2022-09-29," Bridge House,Ballyroe Upper,Kilfinane,Co. Limerick,V35 YD27 ",200000,215000,-15000,-6.98,72,Limerick,Munster
1048,2022-09-29," 23 Stonebridge, Ratoath, Meath ",475000,497500,-22500,-4.52,72,Meath,Leinster
1050,2022-09-29," 7 Brewery Court, Ballinrobe, Mayo ",165000,145000,20000,13.79,73,Mayo,Connaught
1051,2022-09-29," 6 Bayview Pembroke Street , Irishtown, Dublin 4 ",525000,575000,-50000,-8.7,73,Dublin 4,Leinster
1052,2022-09-29," 3 Hacienda , Wynnsward Drive, Clonskeagh, Dublin 14 ",530000,575000,-45000,-7.83,73,Dublin 14,Leinster
1055,2022-09-29," 81 Saunders Lane, Rathnew, Wicklow ",415000,445000,-30000,-6.74,73,Wicklow,Leinster
1056,2022-09-29," The Elliot's, Dunbur Head,, Wicklow Town, Wicklow ",465000,495000,-30000,-6.06,73,Wicklow,Leinster
1057,2022-09-29," 6 Barr Na gCurrach, Baile na hAbhann, Furbo, Galway ",389000,395000,-6000,-1.52,73,Galway,Connaught
1058,2022-09-29," Mountain View , Toneymore ,Abbeylara , Longford ",270000,285000,-15000,-5.26,73,Longford,Leinster
1059,2022-09-29," Cill Dara, Ballymany, Newbridge, Kildare ",390000,445000,-55000,-12.36,73,Kildare,Leinster
1061,2022-09-29," Fernleigh,Park,Stradbally,Co. Laois,R32 T8W8 ",650000,595000,55000,9.24,73,Laois,Leinster
1062,2022-09-29," Clar Aoibheann,Claremorris,Co. Mayo ",39000,50000,-11000,-22.0,73,Mayo,Connaught
1063,2022-09-29," 27 Rice Park, Waterford City, Waterford ",179000,195000,-16000,-8.21,73,Waterford,Munster
1064,2022-09-29," Patrick Street, Mountmellick, Laois ",185000,180000,5000,2.78,73,Laois,Leinster
1065,2022-09-29," 58 Old  Willow Park, Athlone East, Westmeath ",190000,225000,-35000,-15.56,74,Westmeath,Leinster
1066,2022-09-29," 33 Hampton Gardens Drive,Balbriggan,Co. Dublin,K32 E034 ",369000,375000,-6000,-1.6,74,Dublin,Leinster
1067,2022-09-29," 22 King Street,Wexford Town,Y35 V2P5 ",135000,150000,-15000,-10.0,74,Wexford,Leinster
1068,2022-09-29," 24 Avondale,Trim,Co Meath,C15 W860 ",275000,240000,35000,14.58,74,Meath,Leinster
1069,2022-09-28," Ballycotton,Liscannor,Co Clare,V95 NF22 ",375000,395000,-20000,-5.06,74,Clare,Munster
1070,2022-09-28," 6 Green Road, Portlaoise, Co. Laois ",169500,189500,-20000,-10.55,74,Laois,Leinster
1071,2022-09-28," Windmill View,Kerry Pike,Co. Cork ",295000,290000,5000,1.72,74,Cork,Munster
1073,2022-09-28," 2 Inagh Court,Aclare,Co Sligo,F91 H9K2 ",85000,87500,-2500,-2.86,74,Sligo,Connaught
1074,2022-09-28," 12 Westway Lawns, Blanchardstown, Dublin ",280000,285000,-5000,-1.75,74,Dublin,Leinster
1075,2022-09-28," 2 CastleLea, Portarlington, Laois ",255000,265000,-10000,-3.77,74,Laois,Leinster
1076,2022-09-28," Asdee East, Asdee, Ballybunion, Kerry ",225000,245000,-20000,-8.16,74,Kerry,Munster
1077,2022-09-28," Gneeves, Lombardstown, Mallow, Cork ",170000,150000,20000,13.33,74,Cork,Munster
1078,2022-09-28," New Street, Abbeyfeale, Limerick ",139000,159000,-20000,-12.58,75,Limerick,Munster
1080,2022-09-28," 8 Castleview, Graiguecullen, Carlow Town, Carlow, R93 FW92 ",180000,190000,-10000,-5.26,75,Carlow,Leinster
1081,2022-09-28," Little Pebble, Cullenstown, Duncormick, Wexford ",275000,295000,-20000,-6.78,75,Wexford,Leinster
1082,2022-09-28," 55 Belfry Avenue, Dundalk, Co. Louth ",365000,375000,-10000,-2.67,75,Louth,Leinster
1083,2022-09-28," 30 Bellevue Heights, Greystones, Co. Wicklow ",775000,850000,-75000,-8.82,75,Wicklow,Leinster
1084,2022-09-28," No 1 Ashford Pines, Cong, Mayo ",730000,700000,30000,4.29,75,Mayo,Connaught
1085,2022-09-28," 273 Templeogue Road, Templeogue, Dublin 6W ",645000,685000,-40000,-5.84,75,Dublin,Leinster
1086,2022-09-28," 4 Ard Glas,Abbeylands,Ferrybank  , Ferrybank, Waterford ",265000,295000,-30000,-10.17,75,Waterford,Munster
1087,2022-09-28," Kilmoreen House, Kildimo, Co. Limerick ",900000,700000,200000,28.57,75,Limerick,Munster
1089,2022-09-28," Cloonfinglas, Fairymount, Castlerea, Co. Roscommon ",39000,45000,-6000,-13.33,75,Roscommon,Connaught
1090,2022-09-28," 16 Kilgarve Court, Creagh, Ballinasloe, Galway ",220000,245000,-25000,-10.2,76,Galway,Connaught
1091,2022-09-28," Hillcrest, Ringstown, Mountrath, Laois ",335000,350000,-15000,-4.29,76,Laois,Leinster
1093,2022-09-28," 5 Grattan Avenue,Grattan Park,Claremorris,Co Mayo,F12 F7K6 ",159000,169000,-10000,-5.92,76,Mayo,Connaught
1094,2022-09-27," Ashton,Ballyvolan Upper,Newcastle,County Wicklow,A63 F223 ",395000,450000,-55000,-12.22,76,Wicklow,Leinster
1095,2022-09-27," Lands At Corran Beg, Goleen, Skibbereen, Co. Cork ",160000,270000,-110000,-40.74,76,Cork,Munster
1096,2022-09-27," The Holly Bush, Kilmacow, Co. Kilkenny ",259000,249000,10000,4.02,76,Kilkenny,Leinster
1097,2022-09-27," Monroe, Lisronagh, Clonmel, Co. Tipperary ",550000,590000,-40000,-6.78,76,Tipperary,Munster
1099,2022-09-27," 10 Charleston Avenue, Ranelagh,   Dublin 6 ",1100000,1250000,-150000,-12.0,76,Dublin 6,Leinster
1100,2022-09-27," Hyem, Ballycurrane North, Clashmore, Co. Waterford , Clashmore, Waterford ",450000,470000,-20000,-4.26,76,Waterford,Munster
1101,2022-09-27," 85 Rosehill, Wicklow Town, Co. Wicklow ",375000,385000,-10000,-2.6,76,Wicklow,Leinster
1102,2022-09-27," 10 Broadfield Close, Rathcoole, Co. Dublin ",265000,275000,-10000,-3.64,76,Dublin,Leinster
1103,2022-09-27," 36 Elizabeth Street, Drumcondra, Dublin 3 ",295000,324950,-29950,-9.22,77,Dublin 3,Leinster
1104,2022-09-27," Claregalway Village, Claregalway, Galway ",110000,150000,-40000,-26.67,77,Galway,Connaught
1105,2022-09-27," Drumcar, Dunleer, Louth ",345000,375000,-30000,-8.0,77,Louth,Leinster
1106,2022-09-27," 12 The Weir, Marketpoint, Mullingar, Co. Westmeath ",168950,179950,-11000,-6.11,77,Westmeath,Leinster
1107,2022-09-27," Coolnamuck, Inistioge, Kilkenny ",400000,425000,-25000,-5.88,77,Kilkenny,Leinster
1109,2022-09-27," 21 Lavarna Grove, Terenure, Dublin 6W ",895000,950000,-55000,-5.79,77,Dublin,Leinster
1110,2022-09-27," 5B Ashe Street, Youghal, Cork ",190000,199000,-9000,-4.52,77,Cork,Munster
1111,2022-09-27," 43 Meadow Way , Kilkenny, Kilkenny ",325000,345000,-20000,-5.8,77,Kilkenny,Leinster
1113,2022-09-27," 25 Convent Road, Blackrock, County Dublin ",735000,795000,-60000,-7.55,77,Dublin,Leinster
1114,2022-09-27," No. 5 & 5a Rathfarnham Road, Terenure, Dublin 6W ",640000,650000,-10000,-1.54,77,Dublin,Leinster
1115,2022-09-27," 57 Viking Road, Stoneybatter, Dublin 7 , Stoneybatter, Dublin 7 ",295000,340000,-45000,-13.24,77,Dublin 7,Leinster
1116,2022-09-27," 8 Shannon Park, Edgeworthstown, Longford ",145000,170000,-25000,-14.71,77,Longford,Leinster
1117,2022-09-27," 25 The Green, Kilteragh, Dooradoyle, Limerick ",249000,275000,-26000,-9.45,77,Limerick,Munster
1118,2022-09-27," 4 Curragh Hall Court, Tyrrelstown, Dublin 15 ",249950,299950,-50000,-16.67,77,Dublin 15,Leinster
1119,2022-09-27," 40 Beech Hill Drive, Donnybrook, Dublin 4 ",735000,795000,-60000,-7.55,78,Dublin 4,Leinster
1120,2022-09-27," Pairc na Heornan, Ballinagar, Offaly ",350000,369000,-19000,-5.15,78,Offaly,Leinster
1121,2022-09-27," 4 Fernleigh Court, Castleknock, Dublin 15 ",320000,300000,20000,6.67,78,Dublin 15,Leinster
1122,2022-09-27," 28 Castle View, Delvin, Westmeath ",189000,195000,-6000,-3.08,78,Westmeath,Leinster
1123,2022-09-27," 632 Kilkee Bay Apartments, Kilkee, Clare ",180000,175000,5000,2.86,78,Clare,Munster
1124,2022-09-27," 8 Rathlinn, Castleconnell, Limerick ",650000,695000,-45000,-6.47,78,Limerick,Munster
1125,2022-09-27," 97 Dominick Place, Waterford City, Waterford ",165000,159000,6000,3.77,78,Waterford,Munster
1126,2022-09-27," Millstreet, Cappagh, Dungarvan, Co. Waterford ",185000,115000,70000,60.87,78,Waterford,Munster
1127,2022-09-27," 30 Ashfield Grove, Huntstown, Dublin 15 ",340000,310000,30000,9.68,78,Dublin 15,Leinster
1129,2022-09-27," Ardahill,Kilcrohane,Co Cork,P75 Y243 ",495000,345000,150000,43.48,78,Cork,Munster
1130,2022-09-26," Mallahow, Naul, Dublin ",725000,825000,-100000,-12.12,78,Dublin,Leinster
1131,2022-09-26," 27 St Laurence's Park,Wicklow Town,Co. Wicklow,A67 K209 ",485000,520000,-35000,-6.73,78,Wicklow,Leinster
1132,2022-09-26," 12 Elm Court,Lissadell Park,Carney,Co. Sligo,F91A5Y4 ",225000,224000,1000,0.45,79,Sligo,Connaught
1133,2022-09-26," 16 Lake View, Glenamaddy, Castlerea, Co. Roscommon ",220000,250000,-30000,-12.0,79,Roscommon,Connaught
1134,2022-09-26," Apt 2 Carraig Court, Main Street, Blackrock, Co. Dublin ",395000,409500,-14500,-3.54,79,Dublin,Leinster
1135,2022-09-26," Glann,Connolly,Ennis,Co Clare,V95 E9D3 ",125000,100000,25000,25.0,79,Clare,Munster
1136,2022-09-26," Carlow Road , Ballylynan, Laois ",65000,55000,10000,18.18,79,Laois,Leinster
1137,2022-09-26," Courthouse Square,Clifden,Co.Galway,H71 NC52 ",215000,225000,-10000,-4.44,79,Galway,Connaught
1140,2022-09-26," Drom Slinne Portroe, Garrykennedy, Tipperary ",167000,145000,22000,15.17,79,Tipperary,Munster
1141,2022-09-26," 8 John Street South, South City Centre, Dublin 8 ",350000,375000,-25000,-6.67,79,Dublin 8,Leinster
1142,2022-09-26," 6 Centaur Court, Carlow Town, Carlow ",180000,190000,-10000,-5.26,79,Carlow,Leinster
1143,2022-09-26," 33 Mountain View Drive,Arklow,Co. Wicklow,Y14 T688 ",349000,345000,4000,1.16,79,Wicklow,Leinster
1144,2022-09-26," 26 Henry St, Drimna, Kilrush, Clare ",249000,275000,-26000,-9.45,79,Clare,Munster
1145,2022-09-26," Ballinlough Carrigeen, Mooncoin, Kilkenny ",425000,450000,-25000,-5.56,80,Kilkenny,Leinster
1146,2022-09-26," 28 Sullivan Street, Stoneybatter, Dublin 7 ",345000,380000,-35000,-9.21,80,Dublin 7,Leinster
1147,2022-09-26," 27 The Green, Sweetfields, Youghal, Cork ",265000,275000,-10000,-3.64,80,Cork,Munster
1148,2022-09-26," Apt 10 Grosvenor House, Monkstown, Monkstown, County Dublin ",415000,425000,-10000,-2.35,80,Dublin,Leinster
1150,2022-09-26," 28, St Josephs Park, The Lough, Glasheen, Cork ",250000,280000,-30000,-10.71,80,Cork,Munster
1152,2022-09-26," The Lodge, Clonmel, Tipperary ",595000,650000,-55000,-8.46,80,Tipperary,Munster
1153,2022-09-26," 10 Acres Of Development Lands, Clonlara, Co. Clare ",300000,375000,-75000,-20.0,80,Clare,Munster
1155,2022-09-26," Dun Ceilin, 69 Renmore Road, Renmore, Galway ",385000,450000,-65000,-14.44,80,Galway,Connaught
1156,2022-09-26," Apartment 7, 39/40 Dorset Street, Dorset Street, Dublin 1 ",305000,275000,30000,10.91,80,Dublin 1,Leinster
1157,2022-09-26," 29 Churchlands, Slane, Meath ",195000,220000,-25000,-11.36,80,Meath,Leinster
1158,2022-09-24," 2 Cloister Close, Blackrock, Co. Dublin ",695000,725000,-30000,-4.14,80,Dublin,Leinster
1160,2022-09-24," Type C01,Greenhill,Clonhaston,Enniscorthy,Co. Wexford ",245000,240000,5000,2.08,80,Wexford,Leinster
1161,2022-09-23," 8 The Grove,Fairfield Park,Waterford,X91 F9PX ",250000,259000,-9000,-3.47,80,Waterford,Munster
1162,2022-09-23," 7 Brookwood Grove, Artane, Dublin 5 ",525000,575000,-50000,-8.7,80,Dublin 5,Leinster
1163,2022-09-23," Toor, Kilcash, Carrick-on-Suir, Tipperary ",380000,395000,-15000,-3.8,81,Tipperary,Munster
1164,2022-09-23," 1 Rockview Terrace, Arklow, Wicklow ",165000,179000,-14000,-7.82,81,Wicklow,Leinster
1165,2022-09-23," 8 St Patricks Place, Kanturk, Cork ",169000,175000,-6000,-3.43,81,Cork,Munster
1166,2022-09-23," 18 Brooklawn, Woodlawn Rd, Killarney, Kerry ",365000,330000,35000,10.61,81,Kerry,Munster
1168,2022-09-23," 10 Ossory Court, Borris-in-Ossory, Laois ",180000,185000,-5000,-2.7,81,Laois,Leinster
1169,2022-09-23," 15 Bealing Crescent, Tyrrelstown, Dublin 15 ",369000,359000,10000,2.79,81,Dublin 15,Leinster
1170,2022-09-23," Ballytarsna, Cashel, Co. Tipperary ",50000,80000,-30000,-37.5,81,Tipperary,Munster
1171,2022-09-23," 48 Callenders Mill, Celbridge, Kildare ",342000,360000,-18000,-5.0,81,Kildare,Leinster
1173,2022-09-23," Creagh Road, Ballinrobe, Mayo ",155000,165000,-10000,-6.06,81,Mayo,Connaught
1175,2022-09-23," Laurel View, Garrywilliam, Crossabeg, Co. Wexford ",395000,415000,-20000,-4.82,81,Wexford,Leinster
1176,2022-09-23," 27 Gleann Ribh, Lusk, County Dublin ",280000,249000,31000,12.45,81,Dublin,Leinster
1177,2022-09-23," Killadangan, Westport, Mayo ",230000,250000,-20000,-8.0,81,Mayo,Connaught
1178,2022-09-23," 17 Ard na S�, Lis Na Dara, Carrick Road, Dundalk, Co. Louth ",229000,250000,-21000,-8.4,81,Louth,Leinster
1179,2022-09-23," 98 Shrewsbury, Ballsbridge, Dublin 4 ",469000,475000,-6000,-1.26,81,Dublin 4,Leinster
1180,2022-09-23," 77 Cromwellsfort Road, Walkinstown, Dublin 12 ",450000,475000,-25000,-5.26,82,Dublin 12,Leinster
1181,2022-09-23," 78 Annamoe Road, Cabra,   Dublin 7 ",525000,575000,-50000,-8.7,82,Dublin 7,Leinster
1182,2022-09-23," 6 Innisfallen Parade, Dublin 7, Dublin ",260000,285000,-25000,-8.77,82,Dublin 7,Leinster
1183,2022-09-23," Drogheda Road, Duleek, Meath ",350000,300000,50000,16.67,82,Meath,Leinster
1184,2022-09-23," Apartment 10 Beaucourt, Achill Road, Drumcondra, Dublin 9 ",225000,235000,-10000,-4.26,82,Dublin 9,Leinster
1185,2022-09-23," Drumkeelwick,Carrigallen,Co. Leitrim,H12 YC57 ",249500,269500,-20000,-7.42,82,Leitrim,Connaught
1186,2022-09-22," 54 Irish Street,Enniscorthy,Co Wexford,Y21F4AO ",149000,155000,-6000,-3.87,82,Wexford,Leinster
1187,2022-09-22," Curraghgraigue,Enniscorthy,Co Wexford,Y21 C798 ",470000,500000,-30000,-6.0,82,Wexford,Leinster
1188,2022-09-22," 8 Cluain Aoibhinn, Naas, Kildare ",370000,390000,-20000,-5.13,82,Kildare,Leinster
1189,2022-09-22," Crinnage, Co.Galway, Craughwell, Co. Galway ",450000,498000,-48000,-9.64,82,Galway,Connaught
1190,2022-09-22," 7 Railway Village, Rampark, Jenkinstown, Co. Louth ",590000,625000,-35000,-5.6,82,Louth,Leinster
1191,2022-09-22," 34 St Catherine's Terrace, Royal Canal Bank, Phibsboro, Dublin 7 ",585000,645000,-60000,-9.3,82,Dublin 7,Leinster
1192,2022-09-22," Ballingayrour Dromin, Kilmallock, Limerick ",229000,239000,-10000,-4.18,82,Limerick,Munster
1193,2022-09-22," Apt. 3 Dorrins Strand,Strandhill,Co. Sligo,F91X316 ",210000,230000,-20000,-8.7,82,Sligo,Connaught
1194,2022-09-22," Stag Cottage, Laragh East, Glendalough, Wicklow ",498000,525000,-27000,-5.14,83,Wicklow,Leinster
1195,2022-09-22," 30 Latchford Park, Clonee, Dublin 15 ",330000,340000,-10000,-2.94,83,Dublin 15,Leinster
1196,2022-09-22," 16 Oranhill Avenue, Oranhill, Oranmore, Galway ",495000,550000,-55000,-10.0,83,Galway,Connaught
1197,2022-09-22," 1 Allan Dara, Summerhill, Meath ",395000,365000,30000,8.22,83,Meath,Leinster
1198,2022-09-22," 30 Ardamine Court, Ardamine, Wexford ",220000,200000,20000,10.0,83,Wexford,Leinster
1199,2022-09-22," 1 Slaney View, Chapel Hill, Baltinglass, Wicklow ",205000,215000,-10000,-4.65,83,Wicklow,Leinster
1200,2022-09-22," 6 Glentane Close, Ballinasloe, Galway ",275000,295000,-20000,-6.78,83,Galway,Connaught
1201,2022-09-22," Fairymount, Castlerea, Roscommon ",290000,295000,-5000,-1.69,83,Roscommon,Connaught
1202,2022-09-22," Fred's Bar, Rylane, Macroom, Cork ",250000,300000,-50000,-16.67,83,Cork,Munster
1203,2022-09-22," Fred's Bar, Rylane , Macroom, Cork ",250000,215000,35000,16.28,83,Cork,Munster
1205,2022-09-22," Cloonaugh Upper, Drumlish, Longford ",159000,167500,-8500,-5.07,83,Longford,Leinster
1206,2022-09-22," Creevagh More, Ballymahon, Longford ",139000,149000,-10000,-6.71,83,Longford,Leinster
1207,2022-09-22," 2 Tullaskeagh Square, Roscrea, Co. Tipperary ",170000,180000,-10000,-5.56,84,Tipperary,Munster
1208,2022-09-22," Ballynacourty South, Ring, Dungarvan, Waterford ",340000,375000,-35000,-9.33,84,Waterford,Munster
1209,2022-09-22," 90 Bremore Castle , Balbriggan, Dublin ",229950,239950,-10000,-4.17,84,Dublin,Leinster
1210,2022-09-22," 10 The Paddocks Rise , Adamstown, Lucan, Dublin ",395000,375000,20000,5.33,84,Dublin,Leinster
1211,2022-09-22," 28 Cluain Caislean,Ferns,Enniscorthy,Co. Wexford,Y21 D433 ",180000,187000,-7000,-3.74,84,Wexford,Leinster
1212,2022-09-22," Mill Street Townhouse,Mill Street,Timoleague,Co Cork,P72 P033 ",475000,495000,-20000,-4.04,84,Cork,Munster
1213,2022-09-22," 321 Carrick Road,Portlaw,Co. Waterford,X91 E1T1 ",154000,169000,-15000,-8.88,84,Waterford,Munster
1214,2022-09-22," 19 Railway View,Clara,Co Offaly,R35VK74 ",150000,160000,-10000,-6.25,84,Offaly,Leinster
1215,2022-09-21," 58 The Paddocks,Naas,Co. Kildare,W91 PF5P ",395000,410000,-15000,-3.66,84,Kildare,Leinster
1216,2022-09-21," Knockaveen, Scarriff, Clare ",425000,475000,-50000,-10.53,84,Clare,Munster
1217,2022-09-21," Mohercregg,Drumshanbo,Co. Leitrim,N41 TF24 ",140000,260000,-120000,-46.15,84,Leitrim,Connaught
1218,2022-09-21," Lisnolan, Manulla, Balla, Mayo ",75000,98000,-23000,-23.47,84,Mayo,Connaught
1219,2022-09-21," 154 Balrotherty Estate, Tallaght, Dublin 24 ",445000,479950,-34950,-7.28,84,Dublin 24,Leinster
1220,2022-09-21," 309 Ridgepool View Apartment, Barrett Street, Ballina, Co. Mayo, Ballina, Mayo ",109000,115000,-6000,-5.22,84,Mayo,Connaught
1221,2022-09-21," Bolaney,Gorey,Co. Wexford,Y25EV72 ",350000,385000,-35000,-9.09,85,Wexford,Leinster
1222,2022-09-21," 34 Parkmore More, Roscrea, Tipperary ",230000,195000,35000,17.95,85,Tipperary,Munster
1223,2022-09-21," 0.25 Acre Site, Kilrush Road, Ennis, Co. Clare ",120000,75000,45000,60.0,85,Clare,Munster
1224,2022-09-21," 8 River lane, Rotchford Manor , Trim, Meath ",260000,280000,-20000,-7.14,85,Meath,Leinster
1225,2022-09-21," 25 The Rise, Knocknacarra, Co. Galway ",415000,450000,-35000,-7.78,85,Galway,Connaught
1227,2022-09-21," Apartment 8 The Cedar, Cruagh Wood, Stepaside, Dublin ",310000,300000,10000,3.33,85,Dublin,Leinster
1228,2022-09-21," Shangarry, Gurtymadden, Loughrea, Galway ",400000,500000,-100000,-20.0,85,Galway,Connaught
1229,2022-09-21," 189 Bru na Sionna,Shannon,Co Clare,V14 AK74 ",230000,250000,-20000,-8.0,85,Clare,Munster
1230,2022-09-21," Sunaura, 1 Meath Road, Bray, Wicklow ",875000,895000,-20000,-2.23,85,Wicklow,Leinster
1231,2022-09-21," 1-4 Matt Kelly Flats, Main Street, Daingean, Co. Offaly ",175000,210000,-35000,-16.67,85,Offaly,Leinster
1232,2022-09-21," The Blue House, Dungarvan, Kilkenny, Kilkenny ",380000,390000,-10000,-2.56,85,Kilkenny,Leinster
1233,2022-09-21," Ryland Wood, Bunclody, Co. Wexford ",300000,285000,15000,5.26,85,Wexford,Leinster
1234,2022-09-21," 57 College Gate, Townsend Street, South City Centre, Dublin 2 ",300000,285000,15000,5.26,85,Dublin 2,Leinster
1235,2022-09-21," 8 Ceide Diarmada, Ard a Laoi, Castledermot, Co. Kildare ",225000,250000,-25000,-10.0,85,Kildare,Leinster
1236,2022-09-21," Creamery Road, Swanlinbar, Co. Cavan ",215000,230000,-15000,-6.52,86,Cavan,Ulster
1237,2022-09-21," Main Street, Belmullet, Mayo ",220000,355000,-135000,-38.03,86,Mayo,Connaught
1238,2022-09-21," No. 56 Barrett Place, Macroom, Cork ",150000,130000,20000,15.38,86,Cork,Munster
1240,2022-09-20," 13 The Corn Exchange, Poolbeg street, South City Center, Dublin 2, Dublin ",298000,315000,-17000,-5.4,86,Dublin 2,Leinster
1241,2022-09-20," 29 Oakbrook , Castlelake, Carrigtwohill, Cork ",245000,240000,5000,2.08,86,Cork,Munster
1242,2022-09-20," 14 Longwood Avenue, South Circular Road, Portobello, Dublin 8 ",895000,950000,-55000,-5.79,86,Dublin 8,Leinster
1243,2022-09-20," 11 Caledon Court , East Road, East Wall, Dublin 3 ",345000,350000,-5000,-1.43,86,Dublin 3,Leinster
1244,2022-09-20," Leitrim Quay Holiday Complex,Leitrim Village,Carrick-On-Shannon,Leitrim,N41 W225 ",1450000,1200000,250000,20.83,87,Leitrim,Connaught
1245,2022-09-20," Forest View Old Cork Road, Mallow, Cork ",220000,240000,-20000,-8.33,87,Cork,Munster
1246,2022-09-20," Carrick Cottage, Glaslacken, Bunclody, Co. Wexford ",315000,310000,5000,1.61,87,Wexford,Leinster
1247,2022-09-20," Tragara, Nerano Road, Dalkey, Co. Dublin ",2850000,3000000,-150000,-5.0,87,Dublin,Leinster
1248,2022-09-20," 11 The Meadows, Oldtown Mill, Celbridge, Co. Kildare ",350000,365000,-15000,-4.11,87,Kildare,Leinster
1249,2022-09-20," 20 Oakfield Avenue, Glanmire, Cork ",315000,285000,30000,10.53,87,Cork,Munster
1250,2022-09-20," Knockyle, Limerick Road, Roscrea, Co. Tipperary ",179000,195000,-16000,-8.21,87,Tipperary,Munster
1252,2022-09-20," Cuilleen, Creagh, Ballinasloe, Co. Roscommon ",215000,245000,-30000,-12.24,87,Roscommon,Connaught
1253,2022-09-20," 2 Avenue Court, Gorey, Wexford ",415000,425000,-10000,-2.35,87,Wexford,Leinster
1254,2022-09-20," Pound Road , Castlebar, Mayo ",250000,275000,-25000,-9.09,87,Mayo,Connaught
1256,2022-09-20," Ballyturin, Gort, Galway ",50000,40000,10000,25.0,87,Galway,Connaught
1257,2022-09-20," 44 Riverchapel View, Riverchapel, Courtown, Wexford ",170000,185000,-15000,-8.11,87,Wexford,Leinster
1258,2022-09-20," 27 Crescent Court , Cappagh White, Tipperary ",165000,185000,-20000,-10.81,87,Tipperary,Munster
1259,2022-09-20," Glenwood House, Glenabo, Fermoy, Cork ",550000,595000,-45000,-7.56,87,Cork,Munster
1261,2022-09-20," 105 The Ramparts, Willow Avenue, Cherrywood,   Dublin 18 ",295000,310000,-15000,-4.84,88,Dublin 18,Leinster
1263,2022-09-20," Sakura House, Monivea, Galway ",190000,255000,-65000,-25.49,88,Galway,Connaught
1264,2022-09-20," 11 Caislean Riada, Athlone East, Westmeath ",270000,280000,-10000,-3.57,88,Westmeath,Leinster
1265,2022-09-20," Oaklands, Lackyle, County Clare, Ardnacrusha, Co. Clare ",395000,375000,20000,5.33,88,Clare,Munster
1266,2022-09-20," Rednagh Road, Aughrim, Wicklow ",195000,220000,-25000,-11.36,88,Wicklow,Leinster
1267,2022-09-20," Glenlough, Kilcrohane, West Cork ",420000,495000,-75000,-15.15,88,Cork,Munster
1268,2022-09-20," Berehaven Holiday Complex, Waterfall, Castletown Berehaven, West Cork ",3500000,3000000,500000,16.67,88,Cork,Munster
1269,2022-09-20," 21 Hampton Wood Green, Finglas, Dublin 11 ",349950,299950,50000,16.67,88,Dublin 11,Leinster
1270,2022-09-20," 40 Donnellan Avenue, Ceannt Fort, Mount Brown, Kilmainham, Dublin 8 ",365000,380000,-15000,-3.95,88,Dublin 8,Leinster
1271,2022-09-20," 178 Charlemont, Griffith Avenue, Drumcondra, Dublin 9 ",495000,520000,-25000,-4.81,88,Dublin 9,Leinster
1273,2022-09-20," Ballyhighland,Caim,Enniscorthy,Co. Wexford,Y21 E725 ",350000,375000,-25000,-6.67,88,Wexford,Leinster
1274,2022-09-20," Clooncon West, Glenamaddy, Co. Galway ",25000,20000,5000,25.0,88,Galway,Connaught
1275,2022-09-19," 55 Ballybricken,Waterford,X91VK33 ",125000,170000,-45000,-26.47,88,Waterford,Munster
1276,2022-09-19," 2 The Old Library, Chapel Street, Dundalk, Co. Louth ",145000,150000,-5000,-3.33,88,Louth,Leinster
1277,2022-09-19," 20 The Drive, Milltree Park, Ratoath, Co. Meath ",349000,360000,-11000,-3.06,89,Meath,Leinster
1280,2022-09-19," 109 Woodview Elm Park Wilton, Wilton, Cork ",265000,250000,15000,6.0,89,Cork,Munster
1281,2022-09-19," Ballinabarney, Hollyfort, Wexford ",420000,395000,25000,6.33,89,Wexford,Leinster
1282,2022-09-19," 3 Rathbride Close, Kildare Town, Kildare ",450000,470000,-20000,-4.26,89,Kildare,Leinster
1283,2022-09-19," Ullid, Kilmacow, Waterford City, Co. Waterford ",340000,300000,40000,13.33,89,Waterford,Munster
1284,2022-09-19," 3 Líos Dubhaile, Dualla, Cashel, Co. Tipperary ",170000,190000,-20000,-10.53,89,Tipperary,Munster
1285,2022-09-19," Liselican, Borris, Co. Carlow ",565000,495000,70000,14.14,89,Carlow,Leinster
1286,2022-09-19," Shanacloon Bilboa, Cappamore, Limerick ",260000,280000,-20000,-7.14,89,Limerick,Munster
1287,2022-09-19," Derreen, Aughacashel, Co. Leitrim ",36000,27000,9000,33.33,89,Leitrim,Connaught
1288,2022-09-19," Newtown, Garryspillane, Co. Limerick ",199950,220000,-20050,-9.11,89,Limerick,Munster
1289,2022-09-19," 42A Heatherview, Sligo City, Sligo ",215000,210000,5000,2.38,89,Sligo,Connaught
1290,2022-09-19," 9 The Walk, Glenveigh, Navan, Meath ",366000,375000,-9000,-2.4,89,Meath,Leinster
1292,2022-09-19," 13 Kingsfort Manor, Ballintogher, Sligo ",175000,179000,-4000,-2.23,90,Sligo,Connaught
1293,2022-09-19," 3 Landsdowne Valley Crescent, Drimnagh, Dublin ",365000,380000,-15000,-3.95,90,Dublin,Leinster
1297,2022-09-19," 12 Preston Brook, Rathangan, Kildare ",350000,360000,-10000,-2.78,90,Kildare,Leinster
1298,2022-09-19," Ballinacarrig Lower, Ballinaclash, Wicklow ",180000,150000,30000,20.0,90,Wicklow,Leinster
1299,2022-09-19," Kickham Street, Carrick-on-Suir, Tipperary ",85000,100000,-15000,-15.0,90,Tipperary,Munster
1300,2022-09-19," Knockmore Cottage, Ballinagore, Westmeath ",60000,75000,-15000,-20.0,90,Westmeath,Leinster
1302,2022-09-19," 99 Donnybrook Manor, Donnybrook, Dublin 4 ",675000,695000,-20000,-2.88,90,Dublin 4,Leinster
1303,2022-09-19," Errill Village, Co. Laois ",190000,210000,-20000,-9.52,90,Laois,Leinster
1304,2022-09-19," 43 St. Agnes Park, Crumlin, Dublin 12 ",530000,550000,-20000,-3.64,90,Dublin 12,Leinster
1305,2022-09-19," Villanova, 8 Johnstown Garden, Johnstown, Kildare ",395000,370000,25000,6.76,90,Kildare,Leinster
1306,2022-09-18," 9 Tuskar Courtyard, Marina Village, Arklow, Wicklow ",205000,210000,-5000,-2.38,90,Wicklow,Leinster
1307,2022-09-17," 8 Grace Avenue Gracefield Manor, Ballylynan, Laois ",300000,310000,-10000,-3.23,90,Laois,Leinster
1308,2022-09-17," Rosfaraghan, Ferbane, Co. Offaly ",175000,189000,-14000,-7.41,90,Offaly,Leinster
1309,2022-09-17," Heather View,Doolistown,Trim,Co Meath,C15 R868 ",285000,280000,5000,1.79,90,Meath,Leinster
1311,2022-09-17," 49 Brecan Close,Balbriggan,Co. Dublin,K32 RW82 ",239500,245000,-5500,-2.24,91,Dublin,Leinster
1313,2022-09-16," Dillon`s, Main Street, Roscrea, Co. Tipperary ",195000,225000,-30000,-13.33,91,Tipperary,Munster
1314,2022-09-16," St Lucia,Garryvoe,East Cork,P25 KR84 ",650000,590000,60000,10.17,91,Cork,Munster
1315,2022-09-16," Coolroe East,Ballyhar,Co Kerry,V93 W2H9 ",228000,235000,-7000,-2.98,91,Kerry,Munster
1316,2022-09-16," 14 Duffry Gate,Enniscorthy,Co. Wexford,Y21K7X0 ",170000,195000,-25000,-12.82,91,Wexford,Leinster
1317,2022-09-16," 7 Parkwood, Roschoill, Dublin Rd,, Drogheda, Louth ",385000,395000,-10000,-2.53,91,Louth,Leinster
1318,2022-09-16," Derryronane,Swinford,Co. Mayo,F12YF85 ",325000,349000,-24000,-6.88,91,Mayo,Connaught
1319,2022-09-16," 43 Mizen Court, Marina Village, Arklow, Wicklow ",239000,245000,-6000,-2.45,91,Wicklow,Leinster
1320,2022-09-16," 7 Inny Court, Dublin Street, Ballyjamesduff, Co. Cavan ",110000,135000,-25000,-18.52,91,Cavan,Ulster
1321,2022-09-16," 4 Pebble Grove, Pebble Beach , Tramore, Waterford ",180000,190000,-10000,-5.26,91,Waterford,Munster
1322,2022-09-16," The Gables, Ballinamintra, Dunmore East, Co. Waterford ",575000,595000,-20000,-3.36,91,Waterford,Munster
1323,2022-09-16," Sidegate, Moneenroe, Castlecomer, Kilkenny ",230000,245000,-15000,-6.12,91,Kilkenny,Leinster
1324,2022-09-16," 22 Huntstown Wood, Mulhuddart, Dublin 15 ",275000,279000,-4000,-1.43,91,Dublin 15,Leinster
1325,2022-09-16," No. 82 New Street, Macroom, Cork ",178000,190000,-12000,-6.32,91,Cork,Munster
1326,2022-09-16," coolcam, Ballinlough, Roscommon ",35000,50000,-15000,-30.0,91,Roscommon,Connaught
1327,2022-09-16," 3 Blackberry Lane, Rathmines, Dublin 6 ",795000,950000,-155000,-16.32,92,Dublin 6,Leinster
1328,2022-09-16," Oaklawn House, Oaklawns, Carlow Town, Carlow ",90000,100000,-10000,-10.0,92,Carlow,Leinster
1329,2022-09-16," Golden Grove Road, Roscrea, Co. Tipperary ",175000,185000,-10000,-5.41,92,Tipperary,Munster
1330,2022-09-16," 2 Cul Caislean, Taghmon, Co. Wexford ",135000,145000,-10000,-6.9,92,Wexford,Leinster
1331,2022-09-16," Cedar House,Glengarriff,Co Cork,P75 NV05 ",745000,795000,-50000,-6.29,92,Cork,Munster
1332,2022-09-16," 8 Grace Avenue Gracefield Manor, Athy, Kildare ",300000,310000,-10000,-3.23,92,Kildare,Leinster
1333,2022-09-16," 28 The Alders, Avourwen, Drogheda, Meath ",259000,265000,-6000,-2.26,92,Meath,Leinster
1336,2022-09-16," Liscarney, Westport, Mayo ",255000,265000,-10000,-3.77,92,Mayo,Connaught
1337,2022-09-16," 75 North Main St., Wexford, Co. Wexford ",475000,420000,55000,13.1,92,Wexford,Leinster
1338,2022-09-16," Killaclogher , Monivea , Co. Galway,   ",125000,150000,-25000,-16.67,92,Galway,Connaught
1339,2022-09-16," Censure House, Ceanchor Road, Howth, Co. Dublin ",12500000,15000000,-2500000,-16.67,93,Dublin,Leinster
1340,2022-09-16," Former Garda Station & Residence, Ballitore, Kildare ",275000,300000,-25000,-8.33,93,Kildare,Leinster
1341,2022-09-16," Saint Paul's, Tonagha, Thurles, Tipperary ",305000,320000,-15000,-4.69,93,Tipperary,Munster
1342,2022-09-16," 8 Somerton, Castleknock Golf & Country Club, Castleknock, Dublin 15 ",1595000,1695000,-100000,-5.9,93,Dublin 15,Leinster
1343,2022-09-16," Hillcrest, Oakwood, Cork Road, Waterford ",350000,375000,-25000,-6.67,93,Cork,Munster
1344,2022-09-16," Old School House,Corcanadas,Milltown,Co. Cavan,H14 D342 ",160000,180000,-20000,-11.11,93,Cavan,Ulster
1345,2022-09-15," Gort Na Fuinse, Headford, Galway ",300000,295000,5000,1.69,93,Galway,Connaught
1348,2022-09-15," 9 Cionn Torc,Castlepollard,Co. Westmeath,N91X9W9 ",179950,185000,-5050,-2.73,93,Westmeath,Leinster
1349,2022-09-15," 127, Priory Lodge, Celbridge, Kildare ",270000,290000,-20000,-6.9,93,Kildare,Leinster
1350,2022-09-15," Ref 910 - Toreenyduneen, Waterville, Kerry ",348500,338500,10000,2.95,93,Kerry,Munster
1351,2022-09-15," 21 Saint Riochs Court, Rioch Street, Kilkenny, Kilkenny ",225000,240000,-15000,-6.25,93,Kilkenny,Leinster
1352,2022-09-15," 47 Woodlands Park, Arklow, Wicklow ",289000,295000,-6000,-2.03,93,Wicklow,Leinster
1353,2022-09-15," Clonyburn,Bunclody,Co. Wexford,Y21AX79 ",685000,750000,-65000,-8.67,94,Wexford,Leinster
1354,2022-09-15," 16 Convent Park, Kinvara, Galway ",295000,315000,-20000,-6.35,94,Galway,Connaught
1355,2022-09-15," 2 St. Etchen's Court, Kinnegad, Westmeath ",210000,230000,-20000,-8.7,94,Westmeath,Leinster
1356,2022-09-15," Carracastle, Ballina, Mayo ",340000,350000,-10000,-2.86,94,Mayo,Connaught
1357,2022-09-15," 35 Irish Street,Enniscorthy,Co. Wexford,Y21D2V9 ",350000,235000,115000,48.94,94,Wexford,Leinster
1358,2022-09-15," 20 Herbert Street, Dublin 2, Dublin ",2750000,3000000,-250000,-8.33,94,Dublin 2,Leinster
1361,2022-09-15," 11 Georges Avenue, Blackrock, Co. Dublin ",695000,795000,-100000,-12.58,94,Dublin,Leinster
1362,2022-09-15," 102 Saran Wood, Bray, Co. Wicklow ",425000,435000,-10000,-2.3,94,Wicklow,Leinster
1363,2022-09-15," 5 Hazel Court, Galway Road, Tuam, Galway ",295000,315000,-20000,-6.35,94,Galway,Connaught
1365,2022-09-15," Fairway View, Sea Road, Ballymoney, Gorey, Wexford ",850000,750000,100000,13.33,94,Wexford,Leinster
1366,2022-09-15," 15 Harlech Crescent, Ardilea, Clonskeagh,   Dublin 14 ",975000,1195000,-220000,-18.41,94,Dublin 14,Leinster
1368,2022-09-15," Lisaroon, Ballycahill, Thurles, Tipperary ",210000,225000,-15000,-6.67,95,Tipperary,Munster
1369,2022-09-15," 27 Castlecourt,Ballina,Co Mayo,F26 K7C2 ",179000,185000,-6000,-3.24,95,Mayo,Connaught
1370,2022-09-15," 16 Carnegie Court, Swords, County Dublin ",270000,275000,-5000,-1.82,95,Dublin,Leinster
1371,2022-09-15," Fermain,Golf Road,Rush,Co Dublin,K56 W973 ",695000,725000,-30000,-4.14,95,Dublin,Leinster
1372,2022-09-15," Bunahowen, Bangor Erris, Ballina, Mayo ",20000,15000,5000,33.33,95,Mayo,Connaught
1373,2022-09-15," Kinvara West, Kinvara, Galway ",220000,195000,25000,12.82,95,Galway,Connaught
1375,2022-09-15," Bun na Coille, Moycullen, Galway ",335750,387500,-51750,-13.35,95,Galway,Connaught
1376,2022-09-15," The Square, Gort, Galway ",145000,165000,-20000,-12.12,95,Galway,Connaught
1377,2022-09-15," Bohermore, Graiguenamanagh, Kilkenny ",299000,315000,-16000,-5.08,95,Kilkenny,Leinster
1378,2022-09-15," Ballygoonaun , Kilfenora, Clare ",225000,300000,-75000,-25.0,95,Clare,Munster
1380,2022-09-15," Rockhurst, Enniskerry Road, Kilternan, County Dublin ",700000,600000,100000,16.67,95,Dublin,Leinster
1381,2022-09-15," 7 St. Enda's Terrace,Newtown Road,Wexford,Y35 R7X9 ",175000,179000,-4000,-2.23,96,Wexford,Leinster
1382,2022-09-15," Derrydonnell Oranmore, Co. Galway ",420000,435000,-15000,-3.45,96,Galway,Connaught
1383,2022-09-15," 19 Cardy Rock Avenue,Balbriggan,Co. Dublin,K32 KA44 ",375000,395000,-20000,-5.06,96,Dublin,Leinster
1384,2022-09-14," 1 Trinity Street,Wexford,Y35 V264 ",850000,950000,-100000,-10.53,96,Wexford,Leinster
1385,2022-09-14," Clare Glens, Newport, Co. Tipperary ",310000,348000,-38000,-10.92,96,Tipperary,Munster
1387,2022-09-14," 26 Thomas Hand Street,Skerries,Co Dublin,K34 PP73 ",745000,750000,-5000,-0.67,96,Dublin,Leinster
1388,2022-09-14," 26 Thomas Hand Street, Skerries, Dublin ",745000,750000,-5000,-0.67,96,Dublin,Leinster
1389,2022-09-14," 80 College Wood Manor,Clane,Co. Kildare,W91 PA03 ",349000,329000,20000,6.08,96,Kildare,Leinster
1390,2022-09-14," 103 Cedarbrook Walk, Cherry Orchard, Dublin 10 ",195000,225000,-30000,-13.33,96,Dublin 10,Leinster
1393,2022-09-14," 15 Ennafort Road, Raheny, Dublin 5 ",599000,650000,-51000,-7.85,96,Dublin 5,Leinster
1394,2022-09-14," Fuschia Cottage, Upper Pembroke, Passage West, Cork ",310000,325000,-15000,-4.62,97,Cork,Munster
1395,2022-09-14," 45 Quinagh Green, Carlow Town, Carlow ",199000,189000,10000,5.29,97,Carlow,Leinster
1396,2022-09-14," 7 Ring Terrace, Inchicore, Dublin 8 ",325000,295000,30000,10.17,97,Dublin 8,Leinster
1397,2022-09-14," 109 Pairc na mBlath,Ballinroad,Dungarvan,Co Waterford,X35NN29 ",289000,297500,-8500,-2.86,97,Waterford,Munster
1398,2022-09-14," Bridge Road, Glencullen, Dublin ",875000,950000,-75000,-7.89,97,Dublin,Leinster
1399,2022-09-14," Boycetown, Togher, Louth ",150000,130000,20000,15.38,97,Louth,Leinster
1400,2022-09-14," Lands at Kilmoylan, Kilmacthomas, Waterford ",200000,230000,-30000,-13.04,97,Waterford,Munster
1401,2022-09-14," Greenfields, Camolin, Gorey, Wexford ",395000,460000,-65000,-14.13,97,Wexford,Leinster
1402,2022-09-14," 88 Kilkenny Street, Castlecomer, Kilkenny ",255000,275000,-20000,-7.27,97,Kilkenny,Leinster
1404,2022-09-14," 27 Bromley Court,Glebemount,Wicklow Town,Co. Wicklow,A67 YF21 ",450000,495000,-45000,-9.09,97,Wicklow,Leinster
1405,2022-09-14," 25 Ferndale,Ballytruckle,Waterford,X91 P65N ",230000,265000,-35000,-13.21,97,Waterford,Munster
1406,2022-09-13," 19 Connaught Street Parade Phibsboro Dublin 7, Phibsboro, Dublin 7 ",325000,357750,-32750,-9.15,98,Dublin 7,Leinster
1407,2022-09-13," Lisnaville, Fuerty, Co. Roscommon ",20000,40000,-20000,-50.0,98,Roscommon,Connaught
1408,2022-09-13," 7 Mount Gandon, K78, Lucan, Co. Dublin ",480000,430000,50000,11.63,98,Dublin,Leinster
1409,2022-09-13," Westwinds, Porterstown Lane, on approx. 3.5 acres, Ratoath, Co. Meath ",850000,750000,100000,13.33,98,Meath,Leinster
1410,2022-09-13," 201 Emmet Road, Inchicore, Dublin 8 ",500000,450000,50000,11.11,98,Dublin 8,Leinster
1411,2022-09-13," Park, Knocklofty, Clonmel, Co. Tipperary ",200000,260000,-60000,-23.08,98,Tipperary,Munster
1412,2022-09-13," River St, Killenaule, Co. Tipperary ",200000,225000,-25000,-11.11,98,Tipperary,Munster
1413,2022-09-13," Kilmoreen, Kildimo, Co. Limerick ",900000,700000,200000,28.57,98,Limerick,Munster
1414,2022-09-13," 12 Logan Close, Luddan, Buncrana, Co. Donegal ",120000,160000,-40000,-25.0,98,Donegal,Ulster
1415,2022-09-13," 52 Abbeylands, Mullingar, Westmeath ",199950,210000,-10050,-4.79,98,Westmeath,Leinster
1416,2022-09-13," 10 Copper Close, Wheaton Hall, Drogheda, Louth ",350000,325000,25000,7.69,98,Louth,Leinster
1417,2022-09-13," 13 Greenridge Court, Blanchardstown, Dublin 15 ",299000,308000,-9000,-2.92,98,Dublin 15,Leinster
1418,2022-09-13," 22 Marlton Grove, Wicklow Town, Co. Wicklow, Wicklow Town, Wicklow ",350000,250000,100000,40.0,98,Wicklow,Leinster
1419,2022-09-13," Market Square, Mountrath, Co. Laois ",270000,300000,-30000,-10.0,99,Laois,Leinster
1420,2022-09-13," 45 Granville Road, Cabinteely, Dublin 18 ",565000,595000,-30000,-5.04,99,Dublin 18,Leinster
1421,2022-09-13," No.8 Crannog, Keshcarrigan, Co Leitrim N41 YT29 ",149000,135000,14000,10.37,99,Leitrim,Connaught
1422,2022-09-13," 15 Beechwood Heath, Clonsilla, Dublin 15 ",440000,530000,-90000,-16.98,99,Dublin 15,Leinster
1424,2022-09-13," Loisin, New Houses, Kilrane, Co. Wexford ",575000,625000,-50000,-8.0,99,Wexford,Leinster
1425,2022-09-13," 30 Elmpark Avenue, Ranelagh, Dublin 6 ",745000,795000,-50000,-6.29,99,Dublin 6,Leinster
1426,2022-09-13," Booterstown Park, Booterstown, County Dublin ",2750000,2950000,-200000,-6.78,99,Dublin,Leinster
1427,2022-09-13," 14 Nash Street, Inchicore, Dublin 8 ",300000,275000,25000,9.09,99,Dublin 8,Leinster
1428,2022-09-13," 35 Glen Richards Cove, Poulshone, Ardamine, Wexford ",245000,250000,-5000,-2.0,99,Wexford,Leinster
1429,2022-09-13," 22 Aubrey Court Parnell Road, Bray, Wicklow ",275000,265000,10000,3.77,99,Wicklow,Leinster
1431,2022-09-13," 3 Shanakiel Park, Shanakiel, Cork ",350000,380000,-30000,-7.89,99,Cork,Munster
1432,2022-09-13," 9 The Stables  College Rd, City Centre, Galway City ",230000,245000,-15000,-6.12,99,Galway,Connaught
1433,2022-09-13," 67 Castle Way, Golden Lane, Dublin 8, Dublin ",470000,495000,-25000,-5.05,100,Dublin,Leinster
1434,2022-09-13," Rinnaney, Foxford, Mayo ",100000,105000,-5000,-4.76,100,Mayo,Connaught
1435,2022-09-13," 81 Heathfield, Kinnegad, Westmeath ",265000,290000,-25000,-8.62,100,Westmeath,Leinster
1436,2022-09-13," 4 Deerpark Road, Blessington, Wicklow ",382000,385000,-3000,-0.78,100,Wicklow,Leinster
1437,2022-09-13," The Cottage, 10 Beach Road, Passage West, Cork ",168000,185000,-17000,-9.19,100,Cork,Munster
1438,2022-09-13," 81 Hawthorn Village,Saleen,Castlebar,Co. Mayo,F23 E330 ",120000,99500,20500,20.6,100,Mayo,Connaught
1439,2022-09-13," 59 The Green,Clonard Village,Wexford Town,Y35 W654 ",140000,125000,15000,12.0,100,Wexford,Leinster
1440,2022-09-13," Gallon Etra,Canningstown,Co Cavan,H16 VF60 ",250000,225000,25000,11.11,100,Cavan,Ulster
1441,2022-09-12," 14 Lissadell Avenue,Powerscourt,Waterford,X91 KXE2 ",320000,330000,-10000,-3.03,100,Waterford,Munster
1442,2022-09-12," 2 Pine Grove,Coill Fada,Longwood,Co Meath,A83XK65 ",275000,285000,-10000,-3.51,100,Meath,Leinster
1444,2022-09-12," 29A Patrick's Street,Portarlington,Co. Laois,R32 DA38 ",149950,169950,-20000,-11.77,101,Laois,Leinster
1445,2022-09-12," Suffolk St, Kells, Co. Meath ",120000,150000,-30000,-20.0,101,Meath,Leinster
1446,2022-09-12," 60 Blacklion Manor, Greystones, Co. Wicklow ",595000,625000,-30000,-4.8,101,Wicklow,Leinster
1447,2022-09-12," 75 Dakota Court, Royal Canal Bank, Phibsboro,   Dublin 7 ",375000,395000,-20000,-5.06,101,Dublin 7,Leinster
1448,2022-09-12," Aney House, Knocklong, Co. Limerick ",135000,149000,-14000,-9.4,101,Limerick,Munster
1449,2022-09-12," 11 Graysmeadow, Cloghan, Co. Offaly ",185000,189000,-4000,-2.12,101,Offaly,Leinster
1450,2022-09-12," 81 Grange hall, Dunshaughlin, Meath ",365000,375000,-10000,-2.67,101,Meath,Leinster
1451,2022-09-12," Glenheather, 1 Ardcarrig, Tralee, Kerry ",330000,350000,-20000,-5.71,101,Kerry,Munster
1452,2022-09-12," 25 Fortfield Square, Terenure, Dublin 6W ",675000,695000,-20000,-2.88,101,Dublin,Leinster
1453,2022-09-12," 22 Ulverton Road, Dalkey, Dublin ",1975000,2100000,-125000,-5.95,101,Dublin,Leinster
1454,2022-09-12," 42 Willow Green, Athlumney Wood, Navan, Co. Meath ",285000,295000,-10000,-3.39,101,Meath,Leinster
1455,2022-09-12," Ballydrehid,Ballisodare,Co. Sligo,F91F8P5 ",480000,498000,-18000,-3.61,102,Sligo,Connaught
1458,2022-09-12," 13 Riverside, Ballinode, Monaghan ",185000,195000,-10000,-5.13,102,Monaghan,Ulster
1459,2022-09-12," 103 Leargan, Knocknacarra, Co. Galway ",340000,350000,-10000,-2.86,102,Galway,Connaught
1460,2022-09-12," Sefton House, New Road, Allenwood, Kildare ",495000,455000,40000,8.79,102,Kildare,Leinster
1461,2022-09-12," 71 Lake Drive, Kilminchy, Portlaoise, Laois ",225000,240000,-15000,-6.25,102,Laois,Leinster
1462,2022-09-12," Old Luffany, Carrigeen, Mooncoin, Co. Kilkenny ",110000,125000,-15000,-12.0,102,Kilkenny,Leinster
1463,2022-09-12," 16 Cameron Street, Dublin 8, Dublin ",280000,275000,5000,1.82,102,Dublin,Leinster
1464,2022-09-12," 113 Castlemanor, Drogheda, Louth ",259000,285000,-26000,-9.12,102,Louth,Leinster
1465,2022-09-12," 17 Ard Na Mara, Clogherhead, Louth ",259000,280000,-21000,-7.5,102,Louth,Leinster
1466,2022-09-12," 10 Annsbrook, Clonskeagh, Dublin 14 ",1500000,1600000,-100000,-6.25,102,Dublin 14,Leinster
1467,2022-09-12," 17 Tyrconnell Place, Inchicore, Dublin 8 ",370000,295000,75000,25.42,102,Dublin 8,Leinster
1469,2022-09-12," Shanaglish, Gort, Galway ",350000,395000,-45000,-11.39,103,Galway,Connaught
1470,2022-09-12," The Bungalow,Dunbur Road,Wicklow Town,Co. Wicklow,A67 NC84 ",575000,650000,-75000,-11.54,103,Wicklow,Leinster
1471,2022-09-11," 77 Montpelier, Stoneybatter, Dublin 7 ",409000,444950,-35950,-8.08,103,Dublin 7,Leinster
1472,2022-09-11," “Loth Lorien” Ballinclamper, Ballinacourty, , Dungarvan, Waterford ",750000,770000,-20000,-2.6,103,Waterford,Munster
1473,2022-09-11," Church Road, Ballycotton, Midleton, Cork ",250000,220000,30000,13.64,103,Cork,Munster
1474,2022-09-11," Nautilus,Ballinadrisogue,Blackwater,Co. Wexford,Y21 YV07 ",395000,425000,-30000,-7.06,103,Wexford,Leinster
1475,2022-09-10," Laragh,Ballintubber,Co. Roscommon,F45R229 ",350000,295000,55000,18.64,103,Roscommon,Connaught
1476,2022-09-10," Hilltop, Bishops Sreet, Cobh, Co Cork, Cobh, East Cork ",435000,475000,-40000,-8.42,103,Cork,Munster
1477,2022-09-10," Glenderry,Ballyheigue,Co. Kerry,V92 X7D6 ",260000,220000,40000,18.18,103,Kerry,Munster
1478,2022-09-09," 25 Thornberry Square, Clonee, Dublin 15 ",230000,245000,-15000,-6.12,103,Dublin 15,Leinster
1479,2022-09-09," 5 Laburnum Close,Ballyroan Road,Abbeyleix,Co. Laois,R32 KX86 ",339000,335000,4000,1.19,103,Laois,Leinster
1481,2022-09-09," Development Site, Folio: RN6512F, Tarmonbarry, Co. Roscommon ",390000,250000,140000,56.0,103,Roscommon,Connaught
1482,2022-09-09," Apt 1 Newtown Park House, Newtown, Waterford City, Waterford ",175000,190000,-15000,-7.89,104,Waterford,Munster
1483,2022-09-09," 61 The Chase, Ramsgate Village, Gorey, Wexford ",295000,310000,-15000,-4.84,104,Wexford,Leinster
1484,2022-09-09," Rathcoffey, Naas, Kildare ",520000,545000,-25000,-4.59,104,Kildare,Leinster
1485,2022-09-09," Edward Street, Baltinglass, Wicklow ",169000,165000,4000,2.42,104,Wicklow,Leinster
1486,2022-09-09," 2 Crosthwaite Hall, Glenageary, County Dublin ",1025000,1045000,-20000,-1.91,104,Dublin,Leinster
1487,2022-09-09," 42 Leeson Street Upper, and Mews Property To Rear, Donnybrook, Dublin 4 ",2450000,2495000,-45000,-1.8,104,Dublin 4,Leinster
1488,2022-09-09," Grange House. Greenore, Co. Louth ",725000,600000,125000,20.83,104,Louth,Leinster
1489,2022-09-09," Cargagh, Virginia, Cavan ",395000,375000,20000,5.33,104,Cavan,Ulster
1491,2022-09-09," Sarsfield Street, Kilmallock, Co. Limerick ",139000,150000,-11000,-7.33,104,Limerick,Munster
1492,2022-09-09," Creggan, Dublin Rd., Athlone., Athlone East, Westmeath ",180000,150000,30000,20.0,104,Westmeath,Leinster
1494,2022-09-09," Strathdene, Cross Avenue, Blackrock, Co. Dublin, Blackrock, Dublin ",1195000,1300000,-105000,-8.08,104,Dublin,Leinster
1496,2022-09-09," 3 Shrewsbury Wood, Cabinteely, Dublin 18 ",775000,850000,-75000,-8.82,104,Dublin 18,Leinster
1498,2022-09-09," 7 Abbey Road, Thurles, Tipperary ",130000,155000,-25000,-16.13,105,Tipperary,Munster
1499,2022-09-09," 10 Munster Street, Phibsboro, Dublin 7 ",545000,585000,-40000,-6.84,105,Dublin 7,Leinster
1500,2022-09-09," 32 Mountain View Road, Ranelagh, Dublin 6 ",1345000,1495000,-150000,-10.03,105,Dublin 6,Leinster
1501,2022-09-09," 10 Willowmere, Greystones, Co. Wicklow ",395000,425000,-30000,-7.06,105,Wicklow,Leinster
1502,2022-09-09," Eden Lodge,6 Cuirt an Droichead,Sixmilebridge,Co Clare,V95 VX72 ",230000,235000,-5000,-2.13,105,Clare,Munster
1503,2022-09-08," Lakeview,Moylough,Ballinasloe,Co. Galway ",750000,815000,-65000,-7.98,105,Galway,Connaught
1504,2022-09-08," Lecanvey , Westport, Mayo ",375000,450000,-75000,-16.67,105,Mayo,Connaught
1505,2022-09-08," 42 Church Street,Skerries,Co Dublin,K34 WA25 ",638000,650000,-12000,-1.85,105,Dublin,Leinster
1507,2022-09-08," 3 Ridgewood Close, Swords, Dublin ",380000,360000,20000,5.56,105,Dublin,Leinster
1508,2022-09-08," 2 Upper New Street, Wicklow Town, Co. Wicklow ",350000,375000,-25000,-6.67,105,Wicklow,Leinster
1509,2022-09-08," 13 River View, Slane, Meath ",310000,315000,-5000,-1.59,105,Meath,Leinster
1510,2022-09-08," 26 Errew Drive,Lough Rynn,Mohill,Co Leitrim,N41 VY27 ",269950,290000,-20050,-6.91,105,Leitrim,Connaught
1511,2022-09-08," 13 Willow Crescent, Primrose Gate, Celbridge, Co. Kildare ",365000,345000,20000,5.8,106,Kildare,Leinster
1515,2022-09-08," 3 Watermill Road, Raheny, Dublin 5 ",595000,625000,-30000,-4.8,106,Dublin 5,Leinster
1516,2022-09-08," 56 Glantann, Castletroy, Co. Limerick ",295000,285000,10000,3.51,106,Limerick,Munster
1517,2022-09-08," 9 Elm Park,Nutley Lane,Donnybrook,Dublin 4,D04 F6R0 ",1350000,1550000,-200000,-12.9,106,Dublin 4,Leinster
1518,2022-09-08," 144 Clonmacnoise Road, Crumlin, Dublin 12 ",365000,345000,20000,5.8,106,Dublin 12,Leinster
1520,2022-09-08," 3 COMYN PLACE, Drumcondra, Dublin 9 ",395000,425000,-30000,-7.06,106,Dublin 9,Leinster
1521,2022-09-08," 59 Maigh Riocaird, Headford Road, Galway ",249000,269000,-20000,-7.43,106,Galway,Connaught
1522,2022-09-08," Ballinabarney, Redcross, Wicklow ",470000,495000,-25000,-5.05,106,Wicklow,Leinster
1523,2022-09-08," 8 Acha Bhile, Lahinch Road, Ennis, Co. Clare ",205000,219000,-14000,-6.39,106,Clare,Munster
1524,2022-09-08," The Glen · Aghort · Ballinskelligs Co Kerry, V23 YW31, Ballinskelligs, Kerry ",450000,395000,55000,13.92,106,Kerry,Munster
1525,2022-09-08," 36 Crodaun Forest Park, Celbridge, Kildare ",550000,575000,-25000,-4.35,107,Kildare,Leinster
1526,2022-09-08," Cregg, Carrick-on-Suir, Tipperary ",280000,300000,-20000,-6.67,107,Tipperary,Munster
1527,2022-09-08," The Mall, Thomastown, Kilkenny ",138000,150000,-12000,-8.0,107,Kilkenny,Leinster
1532,2022-09-08," Apartment 1, Barrack Street, Kilkenny, Kilkenny ",180000,175000,5000,2.86,107,Kilkenny,Leinster
1533,2022-09-08," Island, Burnfort, Mallow, Cork ",750000,550000,200000,36.36,107,Cork,Munster
1534,2022-09-08," 4 Moore St, Rathdowney, Laois ",180000,200000,-20000,-10.0,107,Laois,Leinster
1535,2022-09-08," 37 Glen Aoibhinn Ardamine, Gorey, Wexford ",310000,325000,-15000,-4.62,107,Wexford,Leinster
1536,2022-09-08," 88 Castleland Park Way, Balbriggan, County Dublin ",370000,345000,25000,7.25,107,Dublin,Leinster
1538,2022-09-08," 3.78 Acres Approximately,Clonkeen,Portlaoise,Co. Laois ",100000,150000,-50000,-33.33,107,Laois,Leinster
1539,2022-09-07," 347 Sundays Well,Naas,Co. Kildare,W91 R9AW ",399000,360000,39000,10.83,107,Kildare,Leinster
1540,2022-09-07," 8 Viking Wharf,Templeshannon,Enniscorthy,Co Wexford,Y21 KE38 ",129000,135000,-6000,-4.44,107,Wexford,Leinster
1541,2022-09-07," Site B,Ballynapierce,Enniscorthy,Co. Wexford ",135000,95000,40000,42.11,108,Wexford,Leinster
1542,2022-09-07," 13 Lynally Grove, Mucklagh, Tullamore, Co. Offaly ",260000,250000,10000,4.0,108,Offaly,Leinster
1543,2022-09-07," 2 Bellview,Kilmallock,Co Limerick,V35 CY63 ",250000,275000,-25000,-9.09,108,Limerick,Munster
1544,2022-09-07," Belgrave Lodge, 1 Belgrave Terrace, Monkstown, Co. Dublin ",2475000,2500000,-25000,-1.0,108,Dublin,Leinster
1545,2022-09-07," 13, 15 Main Street, Clongriffin, Clongriffin, Dublin 13 ",295000,305000,-10000,-3.28,108,Dublin 13,Leinster
1546,2022-09-07," 34 Huntstown Road, Huntstown, Dublin 15 ",275000,260000,15000,5.77,108,Dublin 15,Leinster
1547,2022-09-07," 30 Highthorn Park, Glenageary, County Dublin ",595000,645000,-50000,-7.75,108,Dublin,Leinster
1548,2022-09-07," Glenogue, Ballyfad, Gorey, Wexford ",375000,420000,-45000,-10.71,108,Wexford,Leinster
1549,2022-09-07," 151 Mangerton Road, Drimnagh, Dublin 12 ",330000,350000,-20000,-5.71,108,Dublin 12,Leinster
1550,2022-09-07," 7 Oakleigh, Celbridge, Kildare ",645000,675000,-30000,-4.44,108,Kildare,Leinster
1551,2022-09-07," Park,Ballyellis,Gorey,Co. Wexford,Y25 A6P6 ",299000,330000,-31000,-9.39,108,Wexford,Leinster
1555,2022-09-07," Tubrid, Woodsgift, Urlingford, Kilkenny ",220000,250000,-30000,-12.0,109,Kilkenny,Leinster
1557,2022-09-07," 60 Rosehill, Wicklow Town, Wicklow ",365000,395000,-30000,-7.59,109,Wicklow,Leinster
1558,2022-09-07," Leagaun , Moycullen, Galway ",100000,125000,-25000,-20.0,109,Galway,Connaught
1559,2022-09-07," Mooretown, Ardcath, Meath ",325000,360000,-35000,-9.72,109,Meath,Leinster
1560,2022-09-07," Mooretown, Ardcath, Ashbourne, Meath ",325000,360000,-35000,-9.72,109,Meath,Leinster
1561,2022-09-07," 4 Pearse Street, Cahir, Tipperary ",135000,140000,-5000,-3.57,109,Tipperary,Munster
1562,2022-09-07," 48 Barons Hall Rise, Balbriggan, County Dublin ",190000,210000,-20000,-9.52,109,Dublin,Leinster
1563,2022-09-07," 5A The Grove, Pembroke Wood, Passage West, Cork ",245000,250000,-5000,-2.0,109,Cork,Munster
1564,2022-09-07," 53 Oaklawns,, Paulstown, Kilkenny ",230000,235000,-5000,-2.13,109,Kilkenny,Leinster
1565,2022-09-06," Apartment 25,Lowergate,Cashel,Co Tipperary,E25HH76 ",110000,115000,-5000,-4.35,109,Tipperary,Munster
1566,2022-09-06," Cois Urlann (House Type B),Prosperous,Co. Kildare ",435000,425000,10000,2.35,109,Kildare,Leinster
1567,2022-09-06," The Old Rectory, Clerihan, Newchapel, Clonmel, Co. Tipperary ",325000,395000,-70000,-17.72,109,Tipperary,Munster
1568,2022-09-06," Oakley Park House,On. Approx. 19.34 Ha (47.8 Acres),Kells,County Meath,A82PY88 ",1285000,1500000,-215000,-14.33,109,Meath,Leinster
1569,2022-09-06," Site 4 Ballustree Drive, Loughshinny, County Dublin ",350000,450000,-100000,-22.22,110,Dublin,Leinster
1571,2022-09-06," Pigeon Hill House, Ballymorris, Cratloe, Co. Clare ",550000,650000,-100000,-15.38,110,Clare,Munster
1572,2022-09-06,"  90 Madeira Wood, Enniscorthy, Co. Wexford, Enniscorthy, Wexford ",220000,230000,-10000,-4.35,110,Wexford,Leinster
1573,2022-09-06," Kilfeacle House, Churchquarter, Kilfeacle, Co Tipperary ",1100000,1200000,-100000,-8.33,110,Tipperary,Munster
1574,2022-09-06," 26 Ballybeg, Rathnew, Wicklow ",295000,325000,-30000,-9.23,110,Wicklow,Leinster
1575,2022-09-06," 'Karnak', Killincarrick Road, Greystones, Co. Wicklow ",1000000,1200000,-200000,-16.67,110,Wicklow,Leinster
1577,2022-09-06," Apt 2 Gracefields, Chapel Street, Balbriggan, Dublin ",200000,215000,-15000,-6.98,110,Dublin,Leinster
1578,2022-09-06," Silver Pines, Dalkey Avenue, Dalkey, Co. Dublin ",1550000,1595000,-45000,-2.82,110,Dublin,Leinster
1579,2022-09-06," 1 Sweetmount Mews, Dundrum, Dublin 14 ",550000,575000,-25000,-4.35,110,Dublin 14,Leinster
1580,2022-09-06," 16, Ballycasey Manor, Shannon, Clare ",395000,400000,-5000,-1.25,110,Clare,Munster
1581,2022-09-06," 6 Fair Green, Ballycullane, Wexford ",169000,170000,-1000,-0.59,110,Wexford,Leinster
1582,2022-09-06," 4  Coastguard Court, Cullenstown, Duncormick, Wexford ",197500,235000,-37500,-15.96,111,Wexford,Leinster
1583,2022-09-06," 2 St James Villas, Campile, Wexford ",95000,115000,-20000,-17.39,111,Wexford,Leinster
1584,2022-09-06," 29 Somers Way, Ballycullane, Wexford ",170000,190000,-20000,-10.53,111,Wexford,Leinster
1585,2022-09-06," 36 Castle Park, Swords, County Dublin ",395000,375000,20000,5.33,111,Dublin,Leinster
1586,2022-09-06," Killicar, Milltown, Belturbet, Cavan ",139000,129000,10000,7.75,111,Cavan,Ulster
1588,2022-09-06," 4 Bective Walk, Kilmessan, Meath ",297500,295000,2500,0.85,111,Meath,Leinster
1589,2022-09-06," 38 Chestnut Grove, Beaufort Place, Navan, Meath ",300000,310000,-10000,-3.23,111,Meath,Leinster
1590,2022-09-06," 27, Fernwood, Glanmire, Cork ",390000,355000,35000,9.86,111,Cork,Munster
1591,2022-09-06," 100 Kilfenora Road, Kimmage, Dublin ",280000,289000,-9000,-3.11,111,Dublin,Leinster
1592,2022-09-06," 2 Ferndale Heights,Emyvale,Co. Monaghan,H18YD61 ",240000,185000,55000,29.73,111,Monaghan,Ulster
1593,2022-09-05," Aughoose,Pulathomas,Ballina,Co Mayo,F26 V2F4 ",250000,298000,-48000,-16.11,112,Mayo,Connaught
1594,2022-09-05," Shilmore,Carne,Wexford,Y35WP21 ",299000,349000,-50000,-14.33,112,Wexford,Leinster
1595,2022-09-05," House With 2.2 Acres,Bohea,Liscarney,Westport,Co Mayo ",275000,295000,-20000,-6.78,112,Mayo,Connaught
1597,2022-09-05," Woodfield,Dunmore,Co. Galway,H54 HF58 ",195000,210000,-15000,-7.14,112,Galway,Connaught
1598,2022-09-05," 1 Eiscir Summer Road,Eiscir Meadows,Tullamore,Co Offaly,R35X9E2 ",245000,252000,-7000,-2.78,112,Offaly,Leinster
1599,2022-09-05," 45 Charleville View,Tullamore,Co Offaly,R35YK57 ",400000,430000,-30000,-6.98,112,Offaly,Leinster
1600,2022-09-05," 96 The Village Green,Royal Meadows,Kilcock,Co. Kildare ",550000,499000,51000,10.22,112,Kildare,Leinster
1601,2022-09-05," The Castletown - 4 Bedroom Homes,Westfield,Leixlip,Co. Kildare ",535000,465000,70000,15.05,112,Kildare,Leinster
1602,2022-09-05," Griffinstown Lodge On C.1.8 Acres,Griffinstown,Skeoughvosteen,Co Kilkenny,R95 PW92 ",395000,550000,-155000,-28.18,112,Kilkenny,Leinster
1603,2022-09-05," 535 South Circular Road, Kilmainham, Dublin 8 ",735000,595000,140000,23.53,112,Dublin 8,Leinster
1604,2022-09-05," Lettershanbo, Cloghan, Donegal ",49000,80000,-31000,-38.75,113,Donegal,Ulster
1606,2022-09-05," Asbury,Ballyart,Ballygarrett,Gorey,Co Wexford ",499000,525000,-26000,-4.95,113,Wexford,Leinster
1608,2022-09-05," 37 Woodstream , Castlerea, Roscommon ",165000,160000,5000,3.13,113,Roscommon,Connaught
1611,2022-09-05," 22 Ashwood, Knockcroghery, Co. Roscommon ",215000,225000,-10000,-4.44,113,Roscommon,Connaught
1612,2022-09-05," Greenview, 34A The Great Southern, Newbridge, Kildare ",465000,485000,-20000,-4.12,113,Kildare,Leinster
1613,2022-09-05," 35 Rheban Avenue,Rheban Manor,Athy,Co. Kildare,R14 T283 ",239950,245000,-5050,-2.06,113,Kildare,Leinster
1614,2022-09-05,"  Rathfylane Enniscorthy, Co. Wexford, Enniscorthy, Wexford ",210000,250000,-40000,-16.0,113,Wexford,Leinster
1615,2022-09-05," Creglahan, Castlerea, Roscommon ",20000,25000,-5000,-20.0,114,Roscommon,Connaught
1618,2022-09-05," 102 Heatherview, Tonaphubble, Sligo, , Sligo City, Sligo ",198000,210000,-12000,-5.71,114,Sligo,Connaught
1620,2022-09-05," 9 Chapel View, Louth Village, Co. Louth ",179000,190000,-11000,-5.79,114,Louth,Leinster
1622,2022-09-05," 5 Ginnell Tce, Mullingar, Westmeath ",189000,199000,-10000,-5.03,114,Westmeath,Leinster
1623,2022-09-05," 22 Dun Emer Drive, Dundrum, Dublin 16 ",975000,875000,100000,11.43,114,Dublin 16,Leinster
1624,2022-09-05," 25 Cypress Avenue, Rathfarnham, Dublin 16 ",460000,425000,35000,8.24,114,Dublin 16,Leinster
1625,2022-09-05," 18 Heather Grove, Woodfarm Acres, Palmerstown, Dublin 20 ",500000,445000,55000,12.36,114,Dublin 20,Leinster
1627,2022-09-02," Ballintona, Galbally, Co. Limerick, Tipperary Town, Co. Tipperary ",130000,260000,-130000,-50.0,114,Tipperary,Munster
1628,2022-09-02," 37 George's Avenue, Blackrock, Co. Dublin ",895000,950000,-55000,-5.79,115,Dublin,Leinster
1629,2022-09-02," 1 Glenart Avenue, Blackrock, Co. Dublin ",1450000,1595000,-145000,-9.09,115,Dublin,Leinster
1630,2022-09-02," 6 Prospect Meadows, Prospect Manor, Rathfarnham, Dublin 16 ",550000,575000,-25000,-4.35,115,Dublin 16,Leinster
1631,2022-09-02," Oatquarter, Inishmore, Aran Island, Co.Galway ",200000,150000,50000,33.33,115,Galway,Connaught
1632,2022-09-02," 76 Knockmore,Arklow,County Wicklow,Y14 X452 ",349000,359000,-10000,-2.79,115,Wicklow,Leinster
1635,2022-09-02," 14B Holborn Hill, Belturbet, Cavan ",149000,159000,-10000,-6.29,115,Cavan,Ulster
1638,2022-09-02," 8 Moylaragh Grove,Balbriggan,Co. Dublin,K32 P291 ",320000,265000,55000,20.75,115,Dublin,Leinster
1639,2022-09-02," Apt 3 HILLCREST COURT, Griffith Avenue, Glasnevin, Dublin 9 ",350000,365000,-15000,-4.11,115,Dublin 9,Leinster
1640,2022-09-02," 11 Thomastown Crescent, Sallynoggin, Co. Dublin ",390000,380000,10000,2.63,115,Dublin,Leinster
1641,2022-09-02," BEACON HILL, UPPER ARDMORE, Passage West, Cork ",370000,360000,10000,2.78,115,Cork,Munster
1643,2022-09-02," 12 Castlemill,Balbriggan,Co. Dublin,K32 VE28 ",199500,210000,-10500,-5.0,116,Dublin,Leinster
1644,2022-09-02," 12 Greenhills, Browneshill Road, Carlow Town, Carlow ",250000,230000,20000,8.7,116,Carlow,Leinster
1645,2022-09-02," 2 St. Mary's Terrace,Athlone,Co. Westmeath,N37 X043 ",159500,185000,-25500,-13.78,116,Westmeath,Leinster
1646,2022-09-02," Auburn,Bonavalley,Athlone,Co. Westmeath,N37 KN60 ",290000,325000,-35000,-10.77,116,Westmeath,Leinster
1649,2022-09-02," 5 Springfield, Cavan Town, Co. Cavan ",155000,135000,20000,14.81,116,Cavan,Ulster
1650,2022-09-02," Bleannagloos, Ballygar, Co. Galway ",255000,225000,30000,13.33,116,Galway,Connaught
1651,2022-09-02," 233, The Crescent, Millbrook Lawns, Tallaght, Dublin 24 ",345000,300000,45000,15.0,116,Dublin 24,Leinster
1652,2022-09-02," 10 The Rise, Mullingar, Westmeath ",235000,230000,5000,2.17,116,Westmeath,Leinster
1654,2022-09-02," Main Street, Ennistymon, Co. Clare ",115000,149000,-34000,-22.82,117,Clare,Munster
1655,2022-09-02," 47 Abhainn Glas, Edgeworthstown, Longford ",140000,130000,10000,7.69,117,Longford,Leinster
1656,2022-09-02," 133 The Hermitage, Portlaoise, Laois ",200000,210000,-10000,-4.76,117,Laois,Leinster
1657,2022-09-02," 10 Hunters Place, Hunters Wood, Ballycullen, Dublin 24 ",430000,395000,35000,8.86,117,Dublin 24,Leinster
1658,2022-09-02," 48 Rossvale, Portlaoise, Laois ",255000,265000,-10000,-3.77,117,Laois,Leinster
1659,2022-09-02," Market Street, Ballaghaderreen, Roscommon ",95000,99500,-4500,-4.52,117,Roscommon,Connaught
1660,2022-09-02," Ladyhill, Bodenstown, Sallins, Co. Kildare ",750000,875000,-125000,-14.29,117,Kildare,Leinster
1663,2022-09-01," Corbeagh, Crosserlough, Co. Cavan ",50000,45000,5000,11.11,117,Cavan,Ulster
1665,2022-09-01," 35 Beechwood Park, Kilcoole, Wicklow ",375000,380000,-5000,-1.32,117,Wicklow,Leinster
1666,2022-09-01," 10 St. Patrick`s Crescent, Monkstown, Co. Dublin ",540000,565000,-25000,-4.42,117,Dublin,Leinster
1667,2022-09-01," Kilbride, Newport, Mayo ",375000,385000,-10000,-2.6,117,Mayo,Connaught
1669,2022-09-01," 14 Millstream Court, Kilcullen, Kildare ",369950,375000,-5050,-1.35,118,Kildare,Leinster
1670,2022-09-01," 156 The Oval, Tullyvale, Cabinteely, Dublin 18 ",350000,365000,-15000,-4.11,118,Dublin 18,Leinster
1671,2022-09-01," 56 Danesfort Drive, Loughrea, Co. Galway ",175000,185000,-10000,-5.41,118,Galway,Connaught
1672,2022-09-01," 3 Park Lawn, Drogheda, Louth ",585000,535000,50000,9.35,118,Louth,Leinster
1673,2022-09-01," 9, Hillcrest, Kildorrery, Cork ",210000,200000,10000,5.0,118,Cork,Munster
1674,2022-09-01," 21, O'Neill Crowley Terrace, Mitchelstown, Cork ",140000,145000,-5000,-3.45,118,Cork,Munster
1675,2022-09-01," Halona, Castletown, Wexford ",575000,590000,-15000,-2.54,118,Wexford,Leinster
1676,2022-09-01," Ahiohill, Clonakilty,   West Cork ",525000,495000,30000,6.06,118,Cork,Munster
1679,2022-09-01," 68 Castlemill , Balbriggan,   County Dublin ",200000,230000,-30000,-13.04,118,Dublin,Leinster
1680,2022-09-01," 11 Pine Cove, Dunmore East, Waterford ",349000,375000,-26000,-6.93,118,Waterford,Munster
1682,2022-09-01," 33 The Rise, Ballymurphy Road, Tullow, Carlow ",250000,230000,20000,8.7,118,Carlow,Leinster
1683,2022-09-01," 13 Westway Close, Blanchardstown, Dublin 15 ",280000,290000,-10000,-3.45,119,Dublin 15,Leinster
1684,2022-09-01," 13a Westway Close, Blanchardstown, Dublin 15 ",275000,279950,-4950,-1.77,119,Dublin 15,Leinster
1685,2022-09-01," 37 Cherryfield Park, Hartstown, Dublin 15 ",305000,320000,-15000,-4.69,119,Dublin 15,Leinster
1686,2022-09-01," The Schoolhouse, Sopwell, Cloughjordan, Co. Tipperary ",195000,175000,20000,11.43,119,Tipperary,Munster
1687,2022-08-31," Clonloghan Site 0.3321ha,Newmarket On Fergus,Co Clare ",100000,120000,-20000,-16.67,119,Clare,Munster
1689,2022-08-31," Hillcrest,Athenry Road,Loughrea,Co. Galway,H62 KA07 ",349000,375000,-26000,-6.93,119,Galway,Connaught
1690,2022-08-31," MOHOR,, Ballinasloe, Galway ",185000,225000,-40000,-17.78,119,Galway,Connaught
1691,2022-08-31," Strettel Avenue (3 bed semi), Ballitore, Kildare ",310000,285000,25000,8.77,119,Kildare,Leinster
1692,2022-08-31," Kilconnell, Kilmacrennan, Donegal ",230000,325000,-95000,-29.23,119,Donegal,Ulster
1693,2022-08-31," 21 Castle Park,Athy,Co. Kildare,R14 TW08 ",145000,150000,-5000,-3.33,119,Kildare,Leinster
1695,2022-08-31," 6 Ard Erin, Mountrath, Laois ",200000,210000,-10000,-4.76,120,Laois,Leinster
1696,2022-08-31," 79 Lady's Cross, Clonakilty, Cork ",325000,320000,5000,1.56,120,Cork,Munster
1697,2022-08-31," 94 Meadow Grove, Dundrum, Dublin 16 ",495000,595000,-100000,-16.81,120,Dublin 16,Leinster
1698,2022-08-31," 51 Southern Cross Avenue, Inchicore, Dublin 8 ",470000,425000,45000,10.59,120,Dublin 8,Leinster
1699,2022-08-31," 33 Harold's Cross Cottages, Harold's Cross, Dublin 6 ",330000,285000,45000,15.79,120,Dublin 6,Leinster
1700,2022-08-31," 108 Herberton Road, Rialto, Dublin 8 ",395000,550000,-155000,-28.18,120,Dublin 8,Leinster
1702,2022-08-31," 41 Maelduin, Dunshaughlin, Meath ",395000,295000,100000,33.9,120,Meath,Leinster
1703,2022-08-31," 2 Woodlands Manor, Gorey, Wexford ",274000,280000,-6000,-2.14,120,Wexford,Leinster
1706,2022-08-31," Callanacor, Drumkeen, Co. Donegal ",125000,150000,-25000,-16.67,120,Donegal,Ulster
1708,2022-08-31," 1 Parkside Drive, Balgriffin, Dublin 13 ",450000,445000,5000,1.12,120,Dublin 13,Leinster
1709,2022-08-31," 6 Hampton Court, Inchicore, Dublin 8 ",245000,215000,30000,13.95,120,Dublin 8,Leinster
1710,2022-08-31," Lismongane, Fossa, Killarney, Kerry ",250000,320000,-70000,-21.88,120,Kerry,Munster
1711,2022-08-31," Tullyagan, Mountnugent, Co. Cavan ",390000,400000,-10000,-2.5,120,Cavan,Ulster
1712,2022-08-31," 6 Brackenwood Drive, Balbriggan, County Dublin ",182000,190000,-8000,-4.21,121,Dublin,Leinster
1715,2022-08-31," 60 Gleann Na Ri, Cabinteely, Dublin 18 ",305000,315000,-10000,-3.17,121,Dublin 18,Leinster
1716,2022-08-31," Carrigleigh,Inchigeelagh,Macroom,Co. Cork,P12Y640 ",185000,180000,5000,2.78,121,Cork,Munster
1717,2022-08-30," Correaly,Lismacaffrey,Mullingar,Co. Westmeath,N91YV40 ",140000,169950,-29950,-17.62,121,Westmeath,Leinster
1718,2022-08-30," 6 Shannon Grove,Carrick-On-Shannon,Co. Leitrim,N41 ED73 ",210000,229950,-19950,-8.68,121,Leitrim,Connaught
1719,2022-08-30," Graigue House, Graiguepottle, - on approx. 28 acres, Kilcock, Co. Kildare ",1225000,1450000,-225000,-15.52,121,Kildare,Leinster
1720,2022-08-30," Abbey View, Tyone, Nenagh, Co. Tipperary ",199500,189500,10000,5.28,121,Tipperary,Munster
1721,2022-08-30," 36 Millbrook Court, Kilmainham, Dublin 8 ",295000,325000,-30000,-9.23,121,Dublin 8,Leinster
1722,2022-08-30," Doughill, Kenmare, Kerry ",185000,220000,-35000,-15.91,121,Kerry,Munster
1723,2022-08-30," Thomas Street, Bailieborough, Cavan ",160000,100000,60000,60.0,121,Cavan,Ulster
1724,2022-08-30," Crannagh, Ballyteigue, Rathdrum, Wicklow ",900000,950000,-50000,-5.26,122,Wicklow,Leinster
1725,2022-08-30," 8 Barna Tra, Cliffoney, Sligo ",205000,160000,45000,28.13,122,Sligo,Connaught
1726,2022-08-30," Curraheen, Ballymacoda, Midleton, Cork ",395000,425000,-30000,-7.06,122,Cork,Munster
1727,2022-08-30," Balgeeth, Kells, Co. Meath ",395000,420000,-25000,-5.95,122,Meath,Leinster
1728,2022-08-30," 54 Burgage Manor, Blessington, Co. Wicklow, Blessington, Wicklow ",379000,389000,-10000,-2.57,122,Wicklow,Leinster
1729,2022-08-30," 16 Beechlawn,Portlaoise,Co. Laois,R32 AC0F ",270000,235000,35000,14.89,122,Laois,Leinster
1731,2022-08-30," 3 Fort Lawn Cappa, Kilrush, Clare ",350000,379000,-29000,-7.65,122,Clare,Munster
1732,2022-08-30," Site 6 Lakeview Hill, Bushypark, Galway ",500000,450000,50000,11.11,122,Galway,Connaught
1733,2022-08-30," Thatch Cottage, Kilglass, Legan, Longford ",149000,175000,-26000,-14.86,122,Longford,Leinster
1734,2022-08-30," 2 Boyd House Cun Na Mara Harbour Road   , Howth, Dublin ",450000,495000,-45000,-9.09,122,Dublin,Leinster
1735,2022-08-30," 5 Lily's Way, Ongar, Dublin 15 ",295000,325000,-30000,-9.23,122,Dublin 15,Leinster
1737,2022-08-30," 67 Banna Beach Holiday Homes, Ardfert, Kerry ",90000,110000,-20000,-18.18,122,Kerry,Munster
1738,2022-08-30," Bruno's Take away, 2a Oxmantown Road, Stoneybatter, Dublin 7 ",800000,850000,-50000,-5.88,122,Dublin 7,Leinster
1739,2022-08-30," 1037 Gurteenoona, Monasterevin, Kildare ",340000,350000,-10000,-2.86,123,Kildare,Leinster
1741,2022-08-30," 34 St Maelruans Park, Tallaght,   Dublin 24 ",330000,350000,-20000,-5.71,123,Dublin 24,Leinster
1742,2022-08-30," Coolclogher Lodge, Mill Rd., Killarney, Kerry ",315000,330000,-15000,-4.55,123,Kerry,Munster
1743,2022-08-30," 75 St Joseph's Place, Phibsboro, Dublin 7 ",250000,275000,-25000,-9.09,123,Dublin 7,Leinster
1744,2022-08-29," 84 Windsor Drive, Monkstown, Co. Dublin ",750000,795000,-45000,-5.66,123,Dublin,Leinster
1745,2022-08-29," 1E Edgeworth Court, Longwood, Co. Meath ",345000,325000,20000,6.15,123,Meath,Leinster
1746,2022-08-29," Boleybeg East, Cappagh Road, Barna, Galway ",135000,150000,-15000,-10.0,123,Galway,Connaught
1748,2022-08-29," Ashwood Whitepark, Arklow, Wicklow ",349000,345000,4000,1.16,123,Wicklow,Leinster
1750,2022-08-29," 4 Geraldine Terrace, Longford Town, Co. Longford ",150000,195000,-45000,-23.08,123,Longford,Leinster
1751,2022-08-29," Ballycommane, Durrus, West Cork ",595000,650000,-55000,-8.46,123,Cork,Munster
1752,2022-08-29," Cross , Cross, Mayo ",20000,35000,-15000,-42.86,123,Mayo,Connaught
1754,2022-08-29," 12 Darragh Park, Wicklow Town, Co. Wicklow, Wicklow Town, Wicklow ",340000,375000,-35000,-9.33,124,Wicklow,Leinster
1755,2022-08-29," 32 Glebe Street, Ballinrobe, Mayo ",169000,179000,-10000,-5.59,124,Mayo,Connaught
1757,2022-08-29," Beau Belgree, Belgree, Kilbride, Meath ",475000,495000,-20000,-4.04,124,Meath,Leinster
1758,2022-08-29," Derreen, Louisburgh, Mayo ",390000,410000,-20000,-4.88,124,Mayo,Connaught
1759,2022-08-29," Tobernea West, Effin, Kilmallock, Limerick ",250000,225000,25000,11.11,124,Limerick,Munster
1760,2022-08-29," No. 43 Gladesville , Castlebar, Mayo ",230000,245000,-15000,-6.12,124,Mayo,Connaught
1761,2022-08-29," 172 Drominbeg, Rhebogue, Limerick City ",210000,215000,-5000,-2.33,124,Limerick,Munster
1762,2022-08-29," 35 Raymond Street, South Circular Road,   Dublin 8 ",695000,750000,-55000,-7.33,124,Dublin 8,Leinster
1764,2022-08-29," 438 Railway Terrace, Sallins, Kildare ",155000,186000,-31000,-16.67,124,Kildare,Leinster
1765,2022-08-29," Hawthorn Cottage,Knox,Swinford,Co. Mayo,F12 P892 ",199500,210000,-10500,-5.0,124,Mayo,Connaught
1766,2022-08-27," Churchtown,Mallow,Co. Cork,P51 FT02 ",300000,350000,-50000,-14.29,124,Cork,Munster
1767,2022-08-27," Crann Toradh,West Curragh,Naul,Co. Dublin,K32 NY27 ",449000,475000,-26000,-5.47,124,Dublin,Leinster
1768,2022-08-27," Lackandarra, Colligan, Dungarvan, Waterford ",480000,535000,-55000,-10.28,125,Waterford,Munster
1769,2022-08-27," 34 Sallybrook, Clonea Road, Dungarvan, Waterford ",350000,395000,-45000,-11.39,125,Waterford,Munster
1770,2022-08-27," 41 Kilrane Manor, Kilrane, Wexford ",225000,179950,45050,25.03,125,Wexford,Leinster
1771,2022-08-27," Clonfane House,Athboy Road,Trim,Co Meath,C15 R710 ",840000,1100000,-260000,-23.64,125,Meath,Leinster
1772,2022-08-26," C.0.35 Ha Site At Benamore Business Park, C Benamore, Roscrea, Co. Tipperary ",95000,70000,25000,35.71,125,Tipperary,Munster
1773,2022-08-26," Letter West,Kilcrohane,Co Cork,P75 T049 ",745000,795000,-50000,-6.29,125,Cork,Munster
1774,2022-08-26," 2 X 1 Bed Apartments, 6 Bellview Terrace, Austin Friar St, Mullingar, Co. Westmeath ",204950,224950,-20000,-8.89,125,Westmeath,Leinster
1775,2022-08-26," 2A Old Market Green,Balbriggan,Co. Dublin,K32 HP63 ",289500,269500,20000,7.42,125,Dublin,Leinster
1776,2022-08-26," 22 Parnell Street,Waterford ",300000,250000,50000,20.0,125,Waterford,Munster
1778,2022-08-26," Red Mountain, Donore, Meath ",235000,225000,10000,4.44,125,Meath,Leinster
1779,2022-08-26," The Potato Field, Seamount, Courtown, Wexford ",65000,50000,15000,30.0,125,Wexford,Leinster
1780,2022-08-26," 46 Dursey Row, Waterville, Blanchardstown,   Dublin 15 ",265000,275000,-10000,-3.64,126,Dublin 15,Leinster
1781,2022-08-26," Clare View Cottage, Lehid, Tuam, Galway ",215000,235000,-20000,-8.51,126,Galway,Connaught
1782,2022-08-26," 72 Priory Court, Eden Gate, Delgany, Wicklow ",350000,370000,-20000,-5.41,126,Wicklow,Leinster
1783,2022-08-26," Apt 4 Ardkeen, Dunbur Road, Wicklow Town, Wicklow ",255000,269000,-14000,-5.2,126,Wicklow,Leinster
1784,2022-08-26," Galway's Lane, Douglas, Cork City ",155000,175000,-20000,-11.43,126,Cork,Munster
1786,2022-08-26," 21 Halliday Square, Stoneybatter, Dublin 7 ",395000,440000,-45000,-10.23,126,Dublin 7,Leinster
1787,2022-08-26," Kilbarry East, Dunmanway, Cork ",149000,150000,-1000,-0.67,126,Cork,Munster
1788,2022-08-26," Littlebrook Down, Farranlough, Newcestown, Bandon, West Cork ",549000,579000,-30000,-5.18,126,Cork,Munster
1789,2022-08-26," 44 The Maples, Oakleigh Wood, Ennis, Co. Clare ",325000,385000,-60000,-15.58,126,Clare,Munster
1790,2022-08-26," 12B Stradbrook Apartments, Dublin Rd, Portlaoise, Laois ",125000,145000,-20000,-13.79,126,Laois,Leinster
1791,2022-08-26," 30 Clonattin Close, Gorey, Wexford ",255000,265000,-10000,-3.77,126,Wexford,Leinster
1792,2022-08-26," 4 Castle Demesne, Tralee, Kerry ",350000,340000,10000,2.94,126,Kerry,Munster
1793,2022-08-26," Ardrumkilla, Belclare, Co Galway, Belclare, Galway ",100000,75000,25000,33.33,126,Galway,Connaught
1794,2022-08-26," Lelagh,Rathcabbin,Roscrea,Co Tipperary,R42 TY71 ",245000,255000,-10000,-3.92,127,Tipperary,Munster
1795,2022-08-25," 5 Kilgar, Jocelyn Street, Dundalk, Co. Louth ",165000,160000,5000,3.13,127,Louth,Leinster
1796,2022-08-25," Canagullen,Glanmore Lake,Lauragh,Kenmare,Co. Kerry ",160000,210000,-50000,-23.81,127,Kerry,Munster
1797,2022-08-25," 18 Castlelawn,Tulla Road,Ennis,Co. Clare.,V95 K7RX ",285000,290000,-5000,-1.72,127,Clare,Munster
1798,2022-08-25," 38 Ashfield,Blackwater,Enniscorthy,Co. Wexford,Y21NX44 ",249000,255000,-6000,-2.35,127,Wexford,Leinster
1799,2022-08-25," 3 Glenmaroon Park, Palmerstown, Dublin 20, Dublin ",380000,400000,-20000,-5.0,127,Dublin 20,Leinster
1800,2022-08-25," 49 Twin Oaks, Bailieborough, Co. Cavan ",145000,160000,-15000,-9.38,127,Cavan,Ulster
1801,2022-08-25," 20 Dargan Street , Bray, Wicklow ",275000,295000,-20000,-6.78,127,Wicklow,Leinster
1802,2022-08-25," 21 Birches Close , Tuam, Galway ",210000,220000,-10000,-4.55,127,Galway,Connaught
1803,2022-08-25," 71 Country Meadows, Tuam, Galway ",140000,150000,-10000,-6.67,127,Galway,Connaught
1804,2022-08-25," Ballynakill,Glinsk,Co. Galway,F45 H282 ",245000,260000,-15000,-5.77,127,Galway,Connaught
1806,2022-08-25,"  54 Bridgemeadow, Milehouse Road, Enniscorthy, Co. Wexford, Enniscorthy, Wexford ",235000,250000,-15000,-6.0,127,Wexford,Leinster
1807,2022-08-25," 50 Dromhall Park, Woodlawn Road, Killarney, Co. Kerry ",350000,340000,10000,2.94,127,Kerry,Munster
1809,2022-08-25," 101 Esker Lawns, Lucan, Co. Dublin ",370000,400000,-30000,-7.5,127,Dublin,Leinster
1811,2022-08-25," 21 O Neill Crowley Terrace, Mitchelstown, Cork ",140000,150000,-10000,-6.67,128,Cork,Munster
1812,2022-08-25," Rostollus, Woodford, Woodford, Galway ",239000,195000,44000,22.56,128,Galway,Connaught
1813,2022-08-25," 4 Eiscir Island, Eiscir Meadows, Tullamore, Offaly ",200000,175000,25000,14.29,128,Offaly,Leinster
1814,2022-08-25," 14 Bohernanave, Thurles, Tipperary ",130000,140000,-10000,-7.14,128,Tipperary,Munster
1815,2022-08-25," 16 Millbrook, Milltown, Co. Galway ",90000,70000,20000,28.57,128,Galway,Connaught
1816,2022-08-25," 18 Morton Street, Clonmel, Tipperary ",145000,195000,-50000,-25.64,128,Tipperary,Munster
1817,2022-08-25," 17 Music Hall, Temple Bar, Dublin 2 ",280000,245000,35000,14.29,128,Dublin 2,Leinster
1818,2022-08-25," 76 The Island, Chapelizod, Dublin 20 ",300000,275000,25000,9.09,128,Dublin 20,Leinster
1819,2022-08-25," 17 Goldenbridge Avenue, Inchicore, Dublin 8 ",465000,395000,70000,17.72,128,Dublin 8,Leinster
1821,2022-08-24," No.1 Greenpark Gardens, Sth Circ Rd, Limerick City ",335000,365000,-30000,-8.22,128,Limerick,Munster
1822,2022-08-24," 2.14 Acres Approx.,Clonkeen,Portlaoise,Co. Laois ",80000,160000,-80000,-50.0,128,Laois,Leinster
1823,2022-08-24," 1.48 Acres Approx,Clonkeen,Portlaoise,Co. Laois ",30000,50000,-20000,-40.0,128,Laois,Leinster
1824,2022-08-24," Apt 15 Morrison House, Morrison's Quay, Cork City, Co. Cork ",285000,275000,10000,3.64,129,Cork,Munster
1825,2022-08-24," 58 Jamestown Road, Inchicore, Dublin 8 ",575000,475000,100000,21.05,129,Dublin 8,Leinster
1826,2022-08-24," 74 Laurel Grove, Tagoat, Co. Wexford ",197950,210000,-12050,-5.74,129,Wexford,Leinster
1827,2022-08-24," 9 Blessington Orchard, Blessington, Wicklow ",415000,425000,-10000,-2.35,129,Wicklow,Leinster
1828,2022-08-24," 40 Sraid Na Mara, Sligo City, Sligo ",300000,379000,-79000,-20.84,129,Sligo,Connaught
1829,2022-08-24," Garranacanty, Tipperary Town, Tipperary ",55000,45000,10000,22.22,129,Tipperary,Munster
1831,2022-08-24," 95 The Heath, Ramsgate Village, Gorey, Wexford ",249000,259000,-10000,-3.86,129,Wexford,Leinster
1832,2022-08-24," Mount Melleray, Cappoquin, Waterford ",700000,650000,50000,7.69,129,Waterford,Munster
1833,2022-08-24," 66 College Orchard, Newbridge, Kildare ",292000,320000,-28000,-8.75,129,Kildare,Leinster
1834,2022-08-24," 8 The Avenue, Burkeen, Wicklow Town, Wicklow ",365000,375000,-10000,-2.67,129,Wicklow,Leinster
1835,2022-08-24," Cloghane Village, Cloghane, Kerry ",380000,330000,50000,15.15,129,Kerry,Munster
1836,2022-08-24," 2 Wood Village, Fethard, Wexford ",349950,375000,-25050,-6.68,129,Wexford,Leinster
1837,2022-08-24," Carrigfadda House, Reenascreena, Rosscarbery, West Cork ",350000,390000,-40000,-10.26,129,Cork,Munster
1838,2022-08-24," 1, 2 & 3 Observatory Lane, Rathmines,   Dublin 6 ",1725000,1500000,225000,15.0,130,Dublin 6,Leinster
1839,2022-08-24," Slea Cottage, Damerstown, Muckalee, Co. Kilkenny. ",285000,325000,-40000,-12.31,130,Kilkenny,Leinster
1840,2022-08-24," 6 Sliabh Cairn,Kiltimagh,Co. Mayo,F12 E221 ",175000,165000,10000,6.06,130,Mayo,Connaught
1841,2022-08-24," Apt 4, Marlfield House, Saint Gabriels, Cabinteely, Dublin 18 ",350000,375000,-25000,-6.67,130,Dublin 18,Leinster
1842,2022-08-24," Apartment 53 Ballyowen Hall , Ballyowen Lane, Lucan, Dublin ",250000,260000,-10000,-3.85,130,Dublin,Leinster
1844,2022-08-24," 25 Bremore Castle , Balbriggan,   County Dublin ",295000,310000,-15000,-4.84,130,Dublin,Leinster
1845,2022-08-24," Dublin Road,Kilbeggan,Co Westmeath,N91YA43 ",450000,595000,-145000,-24.37,130,Westmeath,Leinster
1846,2022-08-24," Ballygaddy Road,Tuam,Co. Galway,H54 AE78 ",180000,200000,-20000,-10.0,130,Galway,Connaught
1847,2022-08-24," 48 Marian Square,Clara,Co Offaly,R35P271 ",169000,175000,-6000,-3.43,130,Offaly,Leinster
1848,2022-08-23," Kilfeacle House,Churchquarter,Kilfeacle,Co Tipperary,E34 DR72 ",1100000,1200000,-100000,-8.33,130,Tipperary,Munster
1849,2022-08-23," 65 Willow Park,Ennis,Co. Clare,V95 D2X9 ",205000,175000,30000,17.14,130,Clare,Munster
1850,2022-08-23," 101A The Park, Clon Brugh, Aiken's Village, Sandyford, Dublin 18 ",345000,330000,15000,4.55,130,Dublin 18,Leinster
1851,2022-08-23," 58 Medebawn,Avenue Road,Dundalk,Co. Louth,A91 NX7H ",295000,300000,-5000,-1.67,131,Louth,Leinster
1852,2022-08-23," 14 The Oaks, Wicklow Town, Wicklow ",355000,365000,-10000,-2.74,131,Wicklow,Leinster
1853,2022-08-23," 72 Willowbrook Lawns, Celbridge, Co. Kildare ",345000,365000,-20000,-5.48,131,Kildare,Leinster
1854,2022-08-23," Apt 167, Block D, Bellevue, Islandbridge, Dublin 8 ",325000,338000,-13000,-3.85,131,Dublin 8,Leinster
1857,2022-08-23," Beech Lodge, Lisheenanoran, Corrandulla, Co. Galway ",500000,550000,-50000,-9.09,131,Galway,Connaught
1858,2022-08-23," 67 Connolly Avenue, Inchicore, Dublin 8 ",530000,495000,35000,7.07,131,Dublin 8,Leinster
1859,2022-08-23," 14 Ballyvareen, Kildimo, Co. Limerick ",239000,229000,10000,4.37,131,Limerick,Munster
1861,2022-08-23," 31 Carrick Hall Lane, Edenderry, Offaly ",175000,180000,-5000,-2.78,131,Offaly,Leinster
1862,2022-08-23," 2 & 2A Treaty Villas, High Road, Thomondgate, Co. Limerick ",115000,165000,-50000,-30.3,131,Limerick,Munster
1863,2022-08-23," 31 Standhouse Lawns, Newbridge, Kildare ",300000,275000,25000,9.09,131,Kildare,Leinster
1864,2022-08-23," 52 Old Marian Park, Tralee, Kerry ",135000,125000,10000,8.0,132,Kerry,Munster
1865,2022-08-23," Bayview, Cork Street, Passage West, Cork ",180000,160000,20000,12.5,132,Cork,Munster
1866,2022-08-23," 6 Oaklawn, Leixlip, Co. Kildare ",340000,350000,-10000,-2.86,132,Kildare,Leinster
1867,2022-08-23," Dromville House, Dromadessirt, Killarney, Kerry ",550000,600000,-50000,-8.33,132,Kerry,Munster
1868,2022-08-23," 126 Hazelmere, Naas, Kildare ",299950,315000,-15050,-4.78,132,Kildare,Leinster
1869,2022-08-23," 71 Cashel Road, Crumlin, Dublin 12 ",330000,275000,55000,20.0,132,Dublin 12,Leinster
1871,2022-08-23," Ashfield House,Woodpark,Mallow,Co. Cork.,P51H76K ",525000,495000,30000,6.06,132,Cork,Munster
1873,2022-08-22," Ballylucas, Ballymurn, Co. Wexford ",335000,350000,-15000,-4.29,132,Wexford,Leinster
1875,2022-08-22," ""Elgan"", Knockgreany, Coolgreany, Near Arklow, Coolgreany, Wexford, Y25HW10 ",695000,675000,20000,2.96,132,Wexford,Leinster
1876,2022-08-22," 4 Fairyfield, Parteen, Co. Clare ",395000,435000,-40000,-9.2,132,Clare,Munster
1879,2022-08-22," 74 Lus Mór, Wexford Town, Wexford ",220000,210000,10000,4.76,133,Wexford,Leinster
1881,2022-08-22," 17 Ardmore, Galway, Taylors Hill, Co. Galway ",930000,985000,-55000,-5.58,133,Galway,Connaught
1882,2022-08-22," 1 Ankers Bower, Athlone East, Westmeath ",275000,295000,-20000,-6.78,133,Westmeath,Leinster
1883,2022-08-22," 38 Clonattin Village,Gorey,Co. Wexford,Y25 NW89 ",175000,199500,-24500,-12.28,133,Wexford,Leinster
1884,2022-08-22," Teach Beag, Curranstown, Arklow, Wicklow ",320000,345000,-25000,-7.25,133,Wicklow,Leinster
1885,2022-08-22," 1a Robinhood Park, Clondalkin, Dublin 22 ",295000,345000,-50000,-14.49,133,Dublin 22,Leinster
1886,2022-08-22," 67 Brotherton, Sleaty road, Carlow Town, Co. Carlow ",245000,230000,15000,6.52,133,Carlow,Leinster
1887,2022-08-22," 28 Rosemount Park, Rosegreen, Co. Tipperary ",120000,110000,10000,9.09,133,Tipperary,Munster
1889,2022-08-22," 1 Myra Manor, Malahide, Dublin ",2300000,1900000,400000,21.05,133,Dublin,Leinster
1890,2022-08-22," Main Street Killavullen, Mallow, Cork ",70000,95000,-25000,-26.32,133,Cork,Munster
1891,2022-08-22," Main Street, Dunleer, Louth ",298000,325000,-27000,-8.31,133,Louth,Leinster
1892,2022-08-22," 13 Aranmore Close, Rock Cross, Cavan Town, Co. Cavan ",165000,170000,-5000,-2.94,133,Cavan,Ulster
1893,2022-08-22," 11 Avoca Wood, Avoca, Wicklow ",650000,795000,-145000,-18.24,133,Wicklow,Leinster
1894,2022-08-22," Forthill, Aughnacliffe, Aughnacliffe, Longford ",49000,59000,-10000,-16.95,133,Longford,Leinster
1895,2022-08-22," Cahergal, Union Hall,   West Cork ",275000,295000,-20000,-6.78,133,Cork,Munster
1896,2022-08-22," Ryaninch Lower , Ballina, Tipperary ",595000,625000,-30000,-4.8,133,Tipperary,Munster
1897,2022-08-20," 10 Ardrew Heights, Athy, Kildare ",240000,255000,-15000,-5.88,133,Kildare,Leinster
1898,2022-08-20," 49 Beaufield Park, Stillorgan, Co. Dublin ",700000,675000,25000,3.7,134,Dublin,Leinster
1899,2022-08-20," Banagher,Milltown,Co. Galway,H54 HR20 ",90000,110000,-20000,-18.18,134,Galway,Connaught
1900,2022-08-20," Hawthorn House,Derrygolan,Kilbeggan,Co Westmeath,N91 VX20 ",699000,725000,-26000,-3.59,134,Westmeath,Leinster
1901,2022-08-19," Seffin,Birr,Co Offaly,R42 DN88 ",320000,350000,-30000,-8.57,134,Offaly,Leinster
1902,2022-08-19," Apartments, Currach Cove, Kilkee, Kilrush, Co. Clare ",290000,285000,5000,1.75,134,Clare,Munster
1903,2022-08-19," 6 Beechpark,Claremorris,Co. Mayo,F12X2T6 ",249000,269000,-20000,-7.43,134,Mayo,Connaught
1904,2022-08-19," 57 Block G,Hawthorn Village,Castlebar,Co. Mayo,F23 WN97 ",125000,112500,12500,11.11,134,Mayo,Connaught
1905,2022-08-19," 10 Devon Court, Galway, Salthill, Co. Galway ",695000,690000,5000,0.72,134,Galway,Connaught
1906,2022-08-19," 71 St John's Well Way, D08, Kilmainham, Dublin 8 ",295000,325000,-30000,-9.23,134,Dublin 8,Leinster
1907,2022-08-19," 14 Huntstown Park, Mulhuddart, Dublin ",295000,275000,20000,7.27,134,Dublin,Leinster
1908,2022-08-19," 97 Seven Oaks, Inchicore, Dublin 8 ",310000,250000,60000,24.0,135,Dublin 8,Leinster
1909,2022-08-19," 8 Bow Bridge, Kilmainham, Dublin 8 ",480000,345000,135000,39.13,135,Dublin 8,Leinster
1913,2022-08-19," 9 Crowe Abbey, Greystones, Wicklow ",475000,550000,-75000,-13.64,135,Wicklow,Leinster
1914,2022-08-19," Apartment 19  Block B2, Louisa Park, Leixlip, Co. Kildare ",249000,245000,4000,1.63,135,Kildare,Leinster
1915,2022-08-19," 15 Davis Street, City Centre (Limerick), Limerick City ",370000,350000,20000,5.71,135,Limerick,Munster
1916,2022-08-19," Derrygeel, Lanesboro, Longford ",175000,200000,-25000,-12.5,135,Longford,Leinster
1918,2022-08-19," Crushrod House, Crushrod Avenue, Drogheda, Co. Louth, Drogheda, Louth ",650000,600000,50000,8.33,135,Louth,Leinster
1919,2022-08-19," 108 Saint John's Park, Waterford City, Waterford ",165000,179000,-14000,-7.82,135,Waterford,Munster
1920,2022-08-19," 36 Tully East , Kildare Town, Kildare ",170000,190000,-20000,-10.53,135,Kildare,Leinster
1921,2022-08-18," 15 Summerseat Drive, Co. Meath, Clonee, Dublin 15 ",249000,255000,-6000,-2.35,136,Dublin 15,Leinster
1923,2022-08-18," 4-6 Heytesbury Lane, Ballsbridge,   Dublin 4 ",2400000,3000000,-600000,-20.0,136,Dublin 4,Leinster
1924,2022-08-18," 50 Ard Aoibhinn, Clonmel, Co. Tipperary ",235000,245000,-10000,-4.08,136,Tipperary,Munster
1925,2022-08-18," 4 Arbour Terrace, Stoneybatter, Dublin 7 ",390000,420000,-30000,-7.14,136,Dublin 7,Leinster
1927,2022-08-18," Loughmore at Killeen Castle, Dunsany, Co. Meath - sites with full planning permission ",375000,265000,110000,41.51,136,Meath,Leinster
1928,2022-08-18," 58 Bow Bridge Place, Kilmainham, Dublin 8 ",320000,275000,45000,16.36,136,Dublin 8,Leinster
1929,2022-08-18," Unit 1 Longford Shopping Centre, Longford, Longford ",169000,159000,10000,6.29,136,Longford,Leinster
1930,2022-08-18," 12 Westway Close, Blanchardstown, Dublin 15 ",300000,315000,-15000,-4.76,136,Dublin 15,Leinster
1932,2022-08-18," 3 Edenmore Grove, Raheny, Dublin ",340000,350000,-10000,-2.86,136,Dublin,Leinster
1933,2022-08-18," 128 Fearann Rí, Doughiska, Galway ",225000,245000,-20000,-8.16,136,Galway,Connaught
1934,2022-08-18," Clonbun & Tullyard,Trim,Co. Meath ",640000,625000,15000,2.4,136,Meath,Leinster
1936,2022-08-17," Bunowen Beg,Ballyconneely,Connemara,Co.Galway,H71ER80 ",575000,650000,-75000,-11.54,137,Galway,Connaught
1937,2022-08-17," Carrigadrohid, Macroom, Cork ",195000,190000,5000,2.63,137,Cork,Munster
1938,2022-08-17," Drogheda Street, Monasterevin, Kildare ",390000,430000,-40000,-9.3,137,Kildare,Leinster
1939,2022-08-17," 19 The Orchard,Abbeyfeale,Co. Limerick,V94 A7P2 ",179000,170000,9000,5.29,137,Limerick,Munster
1940,2022-08-17," Eskeragh, Bellacorick, Ballina, Mayo ",120000,150000,-30000,-20.0,137,Mayo,Connaught
1941,2022-08-17," 62 Uam Var Avenue, Bishopstown, Cork ",495000,520000,-25000,-4.81,137,Cork,Munster
1943,2022-08-17," 93 Rath Lodge, Ashbourne, Meath ",299000,330000,-31000,-9.39,137,Meath,Leinster
1944,2022-08-17," 18 Bargy Road, East Wall, Dublin 3 ",325000,350000,-25000,-7.14,137,Dublin 3,Leinster
1945,2022-08-17," 70 The Academy, Park West, Dublin 12 ",240000,195000,45000,23.08,137,Dublin 12,Leinster
1947,2022-08-17," Tall Tree Cottage, Ballynattin, Arklow, Wicklow ",255000,239000,16000,6.69,137,Wicklow,Leinster
1948,2022-08-17," 2 Miners Walk, Crettyard, Laois ",345000,340000,5000,1.47,137,Laois,Leinster
1949,2022-08-17," 1 Millmount Meadows, Avoca, Wicklow ",550000,590000,-40000,-6.78,137,Wicklow,Leinster
1951,2022-08-17," 73 The Glenties, Macroom, Cork ",255000,250000,5000,2.0,137,Cork,Munster
1952,2022-08-17," 1156 Cawdor Street,Rosslare Harbour,Co. Wexford,Y35 A4V2 ",115000,125000,-10000,-8.0,137,Wexford,Leinster
1953,2022-08-17," Garage & Forecourt,Main St,Mullinavat,Co. Kilkenny,KK25603F ",120000,80000,40000,50.0,138,Kilkenny,Leinster
1954,2022-08-16," Main Street,Kingscourt,Co. Cavan,A82 D6H9 ",375000,425000,-50000,-11.76,138,Cavan,Ulster
1955,2022-08-16," 8b Willans Way, Ongar Village, Dublin 15, Dublin ",215000,200000,15000,7.5,138,Dublin 15,Leinster
1956,2022-08-16," 28 Grove Wood , Finglas, Dublin 11 ",395000,425000,-30000,-7.06,138,Dublin 11,Leinster
1957,2022-08-16," 58 Kilnasoolagh Park Newmarket on Fergus Co. Clare, Newmarket on Fergus, Clare ",165000,150000,15000,10.0,138,Clare,Munster
1958,2022-08-16," 90 Silver Springs, Dungarvan, Dungarvan, Waterford ",250000,340000,-90000,-26.47,138,Waterford,Munster
1961,2022-08-16," No. 28 Slaney Street, Enniscorthy, Wexford ",50000,55000,-5000,-9.09,138,Wexford,Leinster
1963,2022-08-16," 21 Stella Maris, Ballisodare, Sligo ",145000,149000,-4000,-2.68,138,Sligo,Connaught
1964,2022-08-16," 10 Ocean Towers, Salthill, Galway City ",397000,420000,-23000,-5.48,138,Galway,Connaught
1965,2022-08-16," Dublin Road, Edgeworthstown, Longford ",180000,195000,-15000,-7.69,138,Longford,Leinster
1966,2022-08-16," 13 Sandymount Court, Sandymount, Dublin 4 ",750000,795000,-45000,-5.66,138,Dublin 4,Leinster
1967,2022-08-16," 24 Heatherfield, Bailieborough, Cavan ",199000,220000,-21000,-9.55,138,Cavan,Ulster
1968,2022-08-16," Pilgrims Rest, Mount Melleray, Cappoquin, Dungarvan, Waterford ",700000,650000,50000,7.69,139,Waterford,Munster
1969,2022-08-16," 2 Glenside, Cappoquin, Waterford ",249000,185000,64000,34.59,139,Waterford,Munster
1970,2022-08-16," Rivendell,Barntown,Co Wexford,Y35 KF50 ",350000,325000,25000,7.69,139,Wexford,Leinster
1971,2022-08-16," 34 St Helens Drive,Kilrane,Co Wexford,Y35XH58 ",299000,329000,-30000,-9.12,139,Wexford,Leinster
1972,2022-08-16," 2 Prospect  Drive,Brooklawns,First Sea Road,Sligo ",220000,230000,-10000,-4.35,139,Sligo,Connaught
1973,2022-08-16," 3 Inis Sioda,Shannon,Co Clare,V14 YV48 ",170000,190000,-20000,-10.53,139,Clare,Munster
1974,2022-08-15," 12 Bachelors Walk,Dundalk,Co. Louth,A91 NW10 ",170000,175000,-5000,-2.86,139,Louth,Leinster
1976,2022-08-15," Type B1 - Four Bed Detached,Cnoic Eoin,Coachford,Co. Cork,P12 TV36 ",460000,450000,10000,2.22,139,Cork,Munster
1977,2022-08-15," Shanakill, Ringville, Dungarvan, Co. Waterford ",100000,90000,10000,11.11,139,Waterford,Munster
1978,2022-08-15," 42 Willow Avenue,Avondale,Trim,Co Meath,C15 P2W0 ",348000,335000,13000,3.88,139,Meath,Leinster
1979,2022-08-15," 501 Mylerstown, Robertstown, Kildare ",595000,675000,-80000,-11.85,139,Kildare,Leinster
1980,2022-08-15," Corbally North, Claregalway, Galway ",455000,495000,-40000,-8.08,139,Galway,Connaught
1981,2022-08-15," 42 Carraig Geal, Loughrea, Co. Galway ",235000,245000,-10000,-4.08,140,Galway,Connaught
1983,2022-08-15," 92-95 Main St, Cashel, Tipperary ",350000,325000,25000,7.69,140,Tipperary,Munster
1985,2022-08-15," Two Bedroom Bungalow,Abbey Grove,Mungret Gate,Mungret,Limerick ",285000,270000,15000,5.56,140,Limerick,Munster
1986,2022-08-15," 1, Dolphin Mews, Dolphin Square, Youghal, Cork ",260000,280000,-20000,-7.14,140,Cork,Munster
1987,2022-08-15," Ashgrove Lodge, Cobh, Cork ",275000,375000,-100000,-26.67,140,Cork,Munster
1988,2022-08-15," 2 Rosehall, Dunmain, New Ross, Wexford ",299950,315000,-15050,-4.78,140,Wexford,Leinster
1989,2022-08-15," 1 Stradbrook Gardens, Stradbrook Road, Blackrock, County Dublin ",495000,530000,-35000,-6.6,140,Dublin,Leinster
1990,2022-08-15," 15 Gracemeadow Park,Stamullen,Co. Meath,K32 E303 ",345000,295000,50000,16.95,140,Meath,Leinster
1991,2022-08-15," 32 The Glen, Kilnacourt Woods, Portarlington, Laois ",195000,210000,-15000,-7.14,140,Laois,Leinster
1994,2022-08-12," Cregg, Craughwell, Co. Galway ",295000,345000,-50000,-14.49,141,Galway,Connaught
1996,2022-08-12," 12 Riverwalk, Tir Cluain, Midleton, Cork ",265000,260000,5000,1.92,141,Cork,Munster
1997,2022-08-12," Coole, Gortnahoe, Thurles, Tipperary ",420000,500000,-80000,-16.0,141,Tipperary,Munster
1998,2022-08-12," 23 Strawberry Hill, Bunclody, Co. Wexford ",159000,165000,-6000,-3.64,141,Wexford,Leinster
1999,2022-08-12," Inishowen,Pound Street,Kilkee,Co. Clare.,V15 E447 ",225000,249000,-24000,-9.64,141,Clare,Munster
2000,2022-08-12," 11 St. Joseph Place, Courtmacsherry,   West Cork ",260000,250000,10000,4.0,141,Cork,Munster
2001,2022-08-12," Vlaanderen,Smiths Road,Charleville,Co. Cork,P56 WF61 ",210000,225000,-15000,-6.67,141,Cork,Munster
2002,2022-08-12," 40 Cluain na Boinne, Johnstown, Navan, Meath ",174500,164500,10000,6.08,141,Meath,Leinster
2003,2022-08-12," Aharney Cottage Aharney, Cullahill, Laois ",260000,250000,10000,4.0,142,Laois,Leinster
2006,2022-08-11," Springmount, Dungarvan, Co. Waterford ",100000,85000,15000,17.65,142,Waterford,Munster
2007,2022-08-11," 43 Mountain road, Cahir, Tipperary ",125000,145000,-20000,-13.79,142,Tipperary,Munster
2009,2022-08-11," 58 Allendale Drive, Clonsilla, Dublin 15 ",325000,310000,15000,4.84,142,Dublin 15,Leinster
2010,2022-08-11," Hawthorn Lane, Clonmines, Wellingtonbridge,  Co. Wexford , Wellingtonbridge, Wexford ",420000,450000,-30000,-6.67,142,Wexford,Leinster
2012,2022-08-11," 34 Woodlands, Oakpark, Tralee, Kerry ",210000,195000,15000,7.69,142,Kerry,Munster
2013,2022-08-11," 28 The Quarry, Carrickhill Road, Portmarnock, County Dublin ",750000,725000,25000,3.45,142,Dublin,Leinster
2014,2022-08-11," Lahinch, 14 Railway Road, Dalkey, Co. Dublin ",1275000,1350000,-75000,-5.56,142,Dublin,Leinster
2015,2022-08-11," 89 Newtown Lawns, Mullingar, Westmeath ",220000,199950,20050,10.03,142,Westmeath,Leinster
2016,2022-08-11," DOONMEEGIN, Ballymote, Sligo ",120000,150000,-30000,-20.0,143,Sligo,Connaught
2017,2022-08-11," Apt 116, Castle Hall, Block C, Swords,   County Dublin ",285000,295000,-10000,-3.39,143,Dublin,Leinster
2018,2022-08-11," 15 Slaney Bank, Rathvilly, Carlow ",249000,285000,-36000,-12.63,143,Carlow,Leinster
2019,2022-08-11," 102 Lough Gate, Portarlington, Laois ",229000,235000,-6000,-2.55,143,Laois,Leinster
2021,2022-08-11," 1 Coole Haven, Gort, Galway ",135000,149000,-14000,-9.4,143,Galway,Connaught
2023,2022-08-11," 30 Glor Na Mara,Grange Road,Rosslare Strand,Co Wexford,Y35 PK59 ",290000,299000,-9000,-3.01,143,Wexford,Leinster
2024,2022-08-11," 12 Millbank Glen,Dromahair,Co. Leitrim,F91E1C9 ",165000,175000,-10000,-5.71,143,Leitrim,Connaught
2025,2022-08-10," 1 The Nurseries,Dublin Road,Maynooth,Co Kildare,W23 TX45 ",220000,235000,-15000,-6.38,143,Kildare,Leinster
2026,2022-08-10," 9 Main Street,Rathcormac,Co Cork,P61 RW93 ",155000,135000,20000,14.81,143,Cork,Munster
2027,2022-08-10," Winterhaven, Mullagh village, Mullagh, Clare ",199000,220000,-21000,-9.55,143,Clare,Munster
2028,2022-08-10," Cleaheen and Derreenannagh,Cootehall,Boyle,Co Roscommon ",150000,210000,-60000,-28.57,143,Roscommon,Connaught
2029,2022-08-10," Clydebank, 58 Castle Road, Dundalk, Co. Louth ",325000,320000,5000,1.56,143,Louth,Leinster
2030,2022-08-10," 11 Alvina Brook, Distillery Road, Wexford, Co. Wexford ",200000,210000,-10000,-4.76,143,Wexford,Leinster
2031,2022-08-10," 2 Wolfe Tone Street, Blackpool, Cork City ",195000,230000,-35000,-15.22,144,Cork,Munster
2032,2022-08-10," 51 Pinebrook Vale, Clonsilla, Dublin 15 ",275000,280000,-5000,-1.79,144,Dublin 15,Leinster
2033,2022-08-10," Claren, Headford, Galway ",55000,60000,-5000,-8.33,144,Galway,Connaught
2034,2022-08-10," Station House, Mulladuff, Smithborough, Monaghan ",157000,180000,-23000,-12.78,144,Monaghan,Ulster
2036,2022-08-10," Mountkelly, Rathvilly, Carlow ",125000,142000,-17000,-11.97,144,Carlow,Leinster
2037,2022-08-10," Emper, Ballynacarrigy, Westmeath ",259000,275000,-16000,-5.82,144,Westmeath,Leinster
2038,2022-08-10," Cedar House,Grange Road,Rosslare Strand,Co. Wexford,Y35 FK19 ",525000,575000,-50000,-8.7,144,Wexford,Leinster
2039,2022-08-10," 19 Teeling Grove,Tubbercurry,Co. Sligo,F91K4W2 ",135000,120000,15000,12.5,144,Sligo,Connaught
2040,2022-08-09," 29 Tara Court Square,Navan,Co Meath,C15 C8X7 ",295000,300000,-5000,-1.67,144,Meath,Leinster
2041,2022-08-09," 51 Woodley Park, Kilmacud, Dublin 14 ",895000,845000,50000,5.92,144,Dublin 14,Leinster
2042,2022-08-09," 1 Court Street, Enniscorthy, Co. Wexford ",350000,400000,-50000,-12.5,144,Wexford,Leinster
2043,2022-08-09," 63 Charleville Avenue, North Strand,   Dublin 3 ",585000,625000,-40000,-6.4,144,Dublin 3,Leinster
2044,2022-08-09," Curnalee,Curraghboy,Athlone,Co. Roscommon,N37 XE06 ",285000,325000,-40000,-12.31,145,Roscommon,Connaught
2045,2022-08-09," 20 Castan, Doughiska Road, Co. Galway ",310000,295000,15000,5.08,145,Galway,Connaught
2046,2022-08-09," Knock View, Knocknasilloge, Blackwater, Wexford ",320000,350000,-30000,-8.57,145,Wexford,Leinster
2047,2022-08-09," Ard Mhuire, Ballybane, Co. Galway ",450000,395000,55000,13.92,145,Galway,Connaught
2048,2022-08-09," Derry, Kilkerrin, Co. Galway ",125000,100000,25000,25.0,145,Galway,Connaught
2049,2022-08-09," 54 Ros Alainn, Macroom, Cork ",267500,257000,10500,4.09,145,Cork,Munster
2051,2022-08-09," 3 Malahide Road, Artane, Dublin 5 ",599000,650000,-51000,-7.85,145,Dublin 5,Leinster
2052,2022-08-09," Cathleens, 45 Northumberland Avenue, Dun Laoghaire, Co. Dublin ",1050000,1100000,-50000,-4.55,145,Dublin,Leinster
2053,2022-08-09," 6 Ashbrooke Manor, Moynehall, Cavan Town, Co. Cavan ",265000,260000,5000,1.92,145,Cavan,Ulster
2054,2022-08-09," 41 Dun Na Carraige, Salthill, Co. Galway ",445000,435000,10000,2.3,145,Galway,Connaught
2055,2022-08-09," 17 Neidin View,Kenmare,Co Kerry,V93 VY10 ",215000,225000,-10000,-4.44,145,Kerry,Munster
2056,2022-08-09," 21 Green Street,Waterford,X91 XRP1 ",260000,299000,-39000,-13.04,145,Waterford,Munster
2057,2022-08-08," The School House,Caherdaniel Village,Co Kerry,V93 RF90 ",289000,320000,-31000,-9.69,145,Kerry,Munster
2058,2022-08-08," 134 Mangerton road, Drimnagh, Dublin 12 ",299950,320000,-20050,-6.27,145,Dublin 12,Leinster
2060,2022-08-08," Waters Edge Cottage, Lauragh, Kerry ",95000,110000,-15000,-13.64,146,Kerry,Munster
2061,2022-08-08," Boolahallagh,Newcastle,Co. Tipperary,000000 ",50000,60000,-10000,-16.67,146,Tipperary,Munster
2063,2022-08-08," Woodside, Tooreenasillane, Skibbereen, Cork ",185000,225000,-40000,-17.78,146,Cork,Munster
2064,2022-08-08," 28 Chestnut Walk, Kilmuckridge, Gorey, Wexford ",220000,230000,-10000,-4.35,146,Wexford,Leinster
2065,2022-08-08," 116 Parnell Road, Dublin 12 ",395000,425000,-30000,-7.06,146,Dublin 12,Leinster
2066,2022-08-08," 3 Distillery Lane, Ashwalk, Ardee, Co. Louth ",135000,150000,-15000,-10.0,146,Louth,Leinster
2067,2022-08-08," 5 Distillery Lane, Ashwalk, A92, Ardee, Co. Louth ",145000,160000,-15000,-9.38,146,Louth,Leinster
2069,2022-08-08," 82 Simmonstown Manor, Celbridge, Co. Kildare ",240000,259000,-19000,-7.34,146,Kildare,Leinster
2070,2022-08-08," Lisbunny, Nenagh, Tipperary ",250000,225000,25000,11.11,146,Tipperary,Munster
2072,2022-08-08," Corracharra, Shantonagh, Castleblayney, Monaghan ",270000,275000,-5000,-1.82,146,Monaghan,Ulster
2073,2022-08-08," Bonners Bar,Mullaghduff,Annagry,Co. Donegal, Annagry, Donegal ",250000,400000,-150000,-37.5,146,Donegal,Ulster
2074,2022-08-08," 18 Mount Argus Park , Harold's Cross, Dublin 6W ",515000,475000,40000,8.42,146,Dublin,Leinster
2075,2022-08-06," Courtyard,Reenmeen East,Glengarriff,Co Cork,P75 Y528 ",1350000,1650000,-300000,-18.18,146,Cork,Munster
2076,2022-08-06," Garrabeg, Gort, Galway ",215000,285000,-70000,-24.56,147,Galway,Connaught
2077,2022-08-06," The Courtyard,Glengarriff,Co. Cork,P75 Y528 ",1350000,1650000,-300000,-18.18,147,Cork,Munster
2078,2022-08-06," The Yews,Rocky Road,Wicklow Town,Co. Wicklow,A67 WP60 ",395000,430000,-35000,-8.14,147,Wicklow,Leinster
2079,2022-08-05," 12 Magheramore,Killimor,Ballinasloe,Co. Galway,H53 FX36 ",210000,195000,15000,7.69,147,Galway,Connaught
2080,2022-08-05," 11 Kilcoolaght Place,Killarney,Co Kerry ",310000,320000,-10000,-3.13,147,Kerry,Munster
2081,2022-08-05," 1 Meadow Avenue, Milltown Road, Tuam, Galway ",310000,300000,10000,3.33,147,Galway,Connaught
2082,2022-08-05," Cnoc na Gr�ine, Furbo, Co. Galway ",120000,150000,-30000,-20.0,147,Galway,Connaught
2083,2022-08-05," 8 Peter Street, Clonmel, Co. Tipperary ",80000,100000,-20000,-20.0,147,Tipperary,Munster
2084,2022-08-05," Framlingham Place, Ballykeenan, Myshall, Co. Carlow ",365000,375000,-10000,-2.67,147,Carlow,Leinster
2085,2022-08-05," Roseacre, Behamore, Cloughjordan, Co. Tipperary ",299950,250000,49950,19.98,147,Tipperary,Munster
2087,2022-08-05," 2 Broomfield Court, Shankill, Dublin 18 ",575000,625000,-50000,-8.0,147,Dublin 18,Leinster
2088,2022-08-05," Bydon, Ballyvodock West, Midleton, Cork ",420000,395000,25000,6.33,147,Cork,Munster
2089,2022-08-05," 44 South Lotts Road, Ringsend, Dublin 4 ",395000,425000,-30000,-7.06,147,Dublin 4,Leinster
2090,2022-08-05," Lisnaville, Fuerty, Roscommon ",350000,300000,50000,16.67,148,Roscommon,Connaught
2091,2022-08-05," 40 Clogher Li, Tralee, Kerry ",299950,320000,-20050,-6.27,148,Kerry,Munster
2093,2022-08-05," Daletree View, Ballycullen, Firhouse, Dublin 24 ",320000,350000,-30000,-8.57,148,Dublin 24,Leinster
2094,2022-08-05," Mutton Lane, Rockbrook, Rathfarnham, Dublin ",185000,200000,-15000,-7.5,148,Dublin,Leinster
2095,2022-08-05," 42 Lus Mor,Whiterock Hill,Co. Wexford,Y35 RFV2 ",179000,189000,-10000,-5.29,148,Wexford,Leinster
2097,2022-08-05," Shop Street,Tuam,Co. Galway,H54 D215 ",185000,175000,10000,5.71,148,Galway,Connaught
2099,2022-08-04," 'Thrush Cottage' 28 Celtic Cottages, Colla Road, Schull,   West Cork ",275000,265000,10000,3.77,148,Cork,Munster
2100,2022-08-04," Moyveela, Oranmore, Galway ",695000,795000,-100000,-12.58,148,Galway,Connaught
2101,2022-08-04," 12A Westway Close, Blanchardstown, Dublin 15 ",285000,300000,-15000,-5.0,148,Dublin 15,Leinster
2104,2022-08-04," Sparrow Road, Dunlavin, Wicklow ",485000,495000,-10000,-2.02,148,Wicklow,Leinster
2105,2022-08-04," Dursey, Fountainstown, Cork ",645000,595000,50000,8.4,148,Cork,Munster
2106,2022-08-04," Ballymabin, Dunmore East, Co. Waterford ",395000,495000,-100000,-20.2,148,Waterford,Munster
2107,2022-08-04," Site Woodvale Grove, Clonsilla, Dublin 15 ",140000,170000,-30000,-17.65,149,Dublin 15,Leinster
2109,2022-08-04," 11 Cahairfuiseog, Herbertstown, Limerick ",390000,370000,20000,5.41,149,Limerick,Munster
2110,2022-08-04," 24 Park Ridge GrangeRath , Drogheda, Meath ",170000,175000,-5000,-2.86,149,Meath,Leinster
2111,2022-08-04," Coolroe, Ballincollig, Cork ",180000,160000,20000,12.5,149,Cork,Munster
2113,2022-08-03," Kilcormac,Boolavogue,Enniscorthy,Co. Wexford,Y21DT21 ",129000,140000,-11000,-7.86,149,Wexford,Leinster
2114,2022-08-03," 10 Churchwood, Coosan, Athlone, Ardmorney, Westmeath ",349000,359000,-10000,-2.79,149,Westmeath,Leinster
2115,2022-08-03," 4.52 Acre Site,Kellystown,Wolfhill,Co Laois ",59950,78500,-18550,-23.63,149,Laois,Leinster
2116,2022-08-03," 37 Waterville Terrace, Blanchardstown, Dublin 15 ",245000,269950,-24950,-9.24,149,Dublin 15,Leinster
2117,2022-08-03," 7 Bracken Drive Old Tramore Road, Waterford City, Waterford ",240000,250000,-10000,-4.0,149,Waterford,Munster
2118,2022-08-03," 2 Deerpark, Baltinglass, Co. Wicklow, Baltinglass, Wicklow ",235000,245000,-10000,-4.08,149,Wicklow,Leinster
2120,2022-08-03," 1 Fairhill, , City Centre Nth, Cork City ",220000,200000,20000,10.0,150,Cork,Munster
2121,2022-08-03," 4 Martello Manor, Strand Road, Bray, Co. Wicklow ",349950,345000,4950,1.43,150,Wicklow,Leinster
2122,2022-08-03," Knockalisheen, Meelick, County Clare ",330000,370000,-40000,-10.81,150,Clare,Munster
2123,2022-08-03," Oldcastle Road, Ballyjamesduff, Co. Cavan ",165000,180000,-15000,-8.33,150,Cavan,Ulster
2124,2022-08-03," Murroe, Dunfanaghy, Co. Donegal ",120000,180000,-60000,-33.33,150,Donegal,Ulster
2126,2022-08-03," 29 Village Gate, Ballycanew, Wexford ",310000,325000,-15000,-4.62,150,Wexford,Leinster
2127,2022-08-03," 438 Tirellan Heights, Headford Road, Galway City ",310000,350000,-40000,-11.43,150,Galway,Connaught
2128,2022-08-03," 4 Manor Drive, Manor Village, Tralee, Kerry ",200000,190000,10000,5.26,150,Kerry,Munster
2129,2022-08-03," 26 Riverside Grove, Ballina, Mayo ",180000,190000,-10000,-5.26,150,Mayo,Connaught
2130,2022-08-03," 37 Castle Grove, Swords, Dublin ",325000,345000,-20000,-5.8,150,Dublin,Leinster
2131,2022-08-03," 3 Summerhill , Waterford City, Waterford ",225000,249000,-24000,-9.64,150,Waterford,Munster
2132,2022-08-03," 2/3 Thomas Ashe Street,Cavan,H12 YC04 ",280000,400000,-120000,-30.0,150,Cavan,Ulster
2134,2022-08-02," 21 Bullawn,New Ross,Co Wexford,Y34 A092 ",135000,139000,-4000,-2.88,150,Wexford,Leinster
2136,2022-08-02," 51 Pinewood Green Avenue,Balbriggan,Co. Dublin,K32 F962 ",249500,279500,-30000,-10.73,151,Dublin,Leinster
2137,2022-08-02," 9.2 Acres Industrially Zoned Lands, Deerpark, Ennistymon, Co. Clare ",300000,450000,-150000,-33.33,151,Clare,Munster
2138,2022-08-02," 10 Tubrid Park, Kenmare, Kerry ",220000,230000,-10000,-4.35,151,Kerry,Munster
2139,2022-08-02," 8 The Oaks, Stradbrook Hill, Blackrock, Co. Dublin ",285000,295000,-10000,-3.39,151,Dublin,Leinster
2140,2022-08-02," 52 McKee Avenue, Finglas, Dublin 11 ",269000,299950,-30950,-10.32,151,Dublin 11,Leinster
2141,2022-08-02," Rosebrook, Drummindoo, Westport, Mayo ",299900,335000,-35100,-10.48,151,Mayo,Connaught
2142,2022-08-02," 11 Mill Street, Drumlish, Longford ",169000,179000,-10000,-5.59,151,Longford,Leinster
2143,2022-08-02," 49 Carraig Geal, Loughrea, Galway, H62H302 ",220000,190000,30000,15.79,151,Galway,Connaught
2144,2022-08-02," 16 Barrowvale, Portlaoise Road, Carlow Town, Co. Carlow ",285000,277500,7500,2.7,151,Carlow,Leinster
2145,2022-08-02," 95 The Clayton, The Gasworks, Ballsbridge, Dublin 4 ",695000,729950,-34950,-4.79,151,Dublin 4,Leinster
2146,2022-08-02," 4 Church View, Faugheen, Carrick-on-Suir, Tipperary ",140000,150000,-10000,-6.67,151,Tipperary,Munster
2148,2022-08-02," 14 Cnoc Na Greine, Mohill, Leitrim ",195000,189000,6000,3.17,151,Leitrim,Connaught
2149,2022-08-02," 24 Knockenrahan, Arklow, Wicklow ",299000,285000,14000,4.91,151,Wicklow,Leinster
2151,2022-08-01," Farnaught, Westport, Mayo ",390000,299900,90100,30.04,151,Mayo,Connaught
2152,2022-07-31," 27 Redmond Cove,Redmond Road,Wexford,Y35 P584 ",175000,195000,-20000,-10.26,151,Wexford,Leinster
2153,2022-07-30," 147 Crossneen Manor,Leighlin Road,Carlow,R93 E8X9 ",249500,259500,-10000,-3.85,152,Carlow,Leinster
2154,2022-07-30," Knockanillaun, Ballina, Mayo ",220000,285000,-65000,-22.81,152,Mayo,Connaught
2156,2022-07-30," 38 Canal View,Clones Rd.,Monaghan,H18 EA34 ",275000,265000,10000,3.77,152,Monaghan,Ulster
2157,2022-07-29," 14 Old Burrin,Old Burrin,Carlow,R93 E6C6 ",229500,239500,-10000,-4.18,152,Carlow,Leinster
2158,2022-07-29," Harmsworth House,Loughagar Beg,Mullingar,Co Westmeath,N91 N5P2 ",995000,1100000,-105000,-9.55,152,Westmeath,Leinster
2159,2022-07-29," 11 Cartron Drive,Athlone,Co Westmeath,N37 Y299 ",295000,325000,-30000,-9.23,152,Westmeath,Leinster
2161,2022-07-29," 198 Cuan Mhuire, Belvedere Hills, Mullingar, Co. Westmeath ",199950,209950,-10000,-4.76,152,Westmeath,Leinster
2162,2022-07-29," Church Street,Abbeyfeale,Co. Limerick,V94 F2A4 ",90000,99000,-9000,-9.09,152,Limerick,Munster
2163,2022-07-29," KILNAGRANGE, Kilmacthomas, Waterford ",565000,535000,30000,5.61,152,Waterford,Munster
2164,2022-07-29," 7 Gort Na Phia,Scaughmolin,Murrintown,Co. Wexford,Y35 HD88 ",410000,425000,-15000,-3.53,152,Wexford,Leinster
2165,2022-07-29," 57 Lough Gate, Portarlington, Laois ",199000,220000,-21000,-9.55,152,Laois,Leinster
2166,2022-07-29," Sarsfield Street, Abbeyside, Dungarvan, Co. Waterford ",110000,100000,10000,10.0,152,Waterford,Munster
2168,2022-07-29," Laburnum House,Air Hill,Roscrea,Co Tipperary,E53 WC94 ",275000,295000,-20000,-6.78,152,Tipperary,Munster
2169,2022-07-29," Rackins, Curraghboy, Roscommon ",295000,280000,15000,5.36,152,Roscommon,Connaught
2170,2022-07-29," Breanamore, Loughglynn, Castlerea, Roscommon ",69000,85000,-16000,-18.82,153,Roscommon,Connaught
2171,2022-07-29," The Fanad Lodge, Fanad, Donegal ",395000,325000,70000,21.54,153,Donegal,Ulster
2172,2022-07-29," Menlo, 36 Summerville Avenue, Waterford., Waterford City, Waterford ",395000,450000,-55000,-12.22,153,Waterford,Munster
2173,2022-07-29," 12 Blessington Street, North City Centre, Dublin 7 ",1200000,1300000,-100000,-7.69,153,Dublin 7,Leinster
2174,2022-07-29," 77 Seaview Park, Portrane, Donabate, County Dublin ",395000,420000,-25000,-5.95,153,Dublin,Leinster
2175,2022-07-29," Swinefield, Cloonfad, Roscommon ",299999,325000,-25001,-7.69,153,Roscommon,Connaught
2176,2022-07-29," Castlecraddock, Dunhill, Waterford ",395000,420000,-25000,-5.95,153,Waterford,Munster
2177,2022-07-29," 19 Olcovar, Shankill, Dublin ",450000,345000,105000,30.43,153,Dublin,Leinster
2179,2022-07-29," 11 Ashbrooke Grove, Cavan  H12KR64 ",250000,175000,75000,42.86,153,Cavan,Ulster
2182,2022-07-29," 166 Claremont Court, Glasnevin,   Dublin 11 ",450000,465000,-15000,-3.23,153,Dublin 11,Leinster
2183,2022-07-29," 126 Oughterany Village, Kilcock, Co Kildare ",339000,349000,-10000,-2.87,153,Kildare,Leinster
2184,2022-07-29," Apt 73 Russell House, Mountjoy Square, Dublin 1 ",295000,340000,-45000,-13.24,153,Dublin 1,Leinster
2185,2022-07-29," 10 Cluain Beag,Clonard,Co. Wexford,Y35 RXT9 ",199000,210000,-11000,-5.24,154,Wexford,Leinster
2186,2022-07-29," 25 Kilcoolaght Place,Killarney,Co Kerry ",320000,310000,10000,3.23,154,Kerry,Munster
2188,2022-07-28," Barrack Street, Gort, Galway ",295000,315000,-20000,-6.35,154,Galway,Connaught
2189,2022-07-28," 7 Bellevue Lawn, Delgany, Co. Wicklow ",725000,750000,-25000,-3.33,154,Wicklow,Leinster
2190,2022-07-28," 8 St. Mary's Court, Arklow, Wicklow ",199000,215000,-16000,-7.44,154,Wicklow,Leinster
2193,2022-07-28," 28 Fullers Road, Cork City Centre, The Lough, Co. Cork ",155000,165000,-10000,-6.06,154,Cork,Munster
2194,2022-07-28," Tonaphubble Road, Tonaphubble, Sligo City, Sligo ",195000,245000,-50000,-20.41,154,Sligo,Connaught
2195,2022-07-28," No. 24 Summer Cove, Lahinch, Clare ",270000,280000,-10000,-3.57,154,Clare,Munster
2196,2022-07-28," c. 1 acre at Lough Hyne Road, Skibbereen, Cork ",55000,40000,15000,37.5,154,Cork,Munster
2197,2022-07-28," St. Mary's Hill, Edenderry, Offaly ",250000,290000,-40000,-13.79,154,Offaly,Leinster
2203,2022-07-28," 30 Harcourt Lodge, Inchicore, Dublin 8 ",250000,260000,-10000,-3.85,155,Dublin 8,Leinster
2204,2022-07-28," 2 The Willows, Orwell Road, Rathgar, Dublin 6 ",995000,1150000,-155000,-13.48,155,Dublin 6,Leinster
2206,2022-07-28," 8 Castlewoods,Piercestown,Co Wexford,Y35 D651 ",299000,305000,-6000,-1.97,155,Wexford,Leinster
2207,2022-07-27," 80 Creagh Woods,Gorey,Co Wexford,Y25 E1V3 ",269000,275000,-6000,-2.18,155,Wexford,Leinster
2208,2022-07-27," Tiernaglohane,Cooraclare,Kilrush,Co. Clare.,V15 XH32 ",90000,85000,5000,5.88,155,Clare,Munster
2209,2022-07-27," No. 16 Primrose Banks, Cois Maigh, Mogeely, Cork ",250000,275000,-25000,-9.09,155,Cork,Munster
2212,2022-07-27," Lissava, Cahir, Co. Tipperary ",55000,75000,-20000,-26.67,155,Tipperary,Munster
2214,2022-07-27," Kilnacrott, Ballyjamesduff, Co Cavan  A82V4P9 ",280000,245000,35000,14.29,155,Cavan,Ulster
2215,2022-07-27," Main Street, Emly, Co Tipperary ",335000,290000,45000,15.52,156,Tipperary,Munster
2216,2022-07-27," Ard Alainn (Phase 2), Portsalon, Donegal, F92WD82 ",400000,290000,110000,37.93,156,Donegal,Ulster
2218,2022-07-27," Main Street, Ballylynan, Laois ",225000,268000,-43000,-16.04,156,Laois,Leinster
2219,2022-07-27," 68 Sliabh Rua,Moate,Co. Westmeath,N37 HP92 ",225000,239000,-14000,-5.86,156,Westmeath,Leinster
2221,2022-07-27," Knightswood, Mullingar, Westmeath ",599000,675000,-76000,-11.26,156,Westmeath,Leinster
2222,2022-07-27," Apt. 2 Clarendon Court,Penrose Lane,Waterford City,Waterford,X91 KD37 ",67000,65000,2000,3.08,156,Waterford,Munster
2223,2022-07-27," 5 Ebenezer Terrace, South Circular Road,   Dublin 8 ",525000,550000,-25000,-4.55,156,Dublin 8,Leinster
2224,2022-07-27," Knockbaun, Abbeyleix, Laois ",650000,1000000,-350000,-35.0,156,Laois,Leinster
2226,2022-07-27," Foresters Cottage,Davidstown,Enniscorthy,Co. Wexford.,Y21 X7K2 ",300000,310000,-10000,-3.23,156,Wexford,Leinster
2227,2022-07-27," 4 The Birches Close,Galway Road,Tuam,Co. Galway,H54 C993 ",230000,242000,-12000,-4.96,156,Galway,Connaught
2228,2022-07-27," 79 Lackanash,Trim,Co Meath,C15 RX36 ",350000,370000,-20000,-5.41,157,Meath,Leinster
2229,2022-07-26," Ballyadam,Carrigtwohill,Co Cork,T45 XK03 ",295000,220000,75000,34.09,157,Cork,Munster
2230,2022-07-26," 136 Meadow Gate,Gorey,Co. Wexford,Y25H2V9 ",289000,275000,14000,5.09,157,Wexford,Leinster
2231,2022-07-26," Cedar Lodge,Monageer,Enniscorthy,Co Wexford,Y21YY07 ",110000,95000,15000,15.79,157,Wexford,Leinster
2232,2022-07-26," Springfield House, Tullylost, Rathangan, Kildare ",550000,750000,-200000,-26.67,157,Kildare,Leinster
2233,2022-07-26," 49 Rosedale Close, Castaheany, Clonee, Dublin 15 ",230000,245000,-15000,-6.12,157,Dublin 15,Leinster
2235,2022-07-26," 28, Thomas Hand Street, Skerries, County Dublin ",315000,335000,-20000,-5.97,157,Dublin,Leinster
2236,2022-07-26," 11 The Maples, Monkstown Valley, Dublin ",485000,535000,-50000,-9.35,157,Dublin,Leinster
2237,2022-07-26," 29 Waltrim Grove, Killarney Road, Bray, Co. Wicklow ",295000,275000,20000,7.27,157,Wicklow,Leinster
2238,2022-07-26," Clash, Kanturk, Cork ",195000,225000,-30000,-13.33,157,Cork,Munster
2239,2022-07-26," 69 Priory Lodge, St. Raphaels Manor, Celbridge, Co. Kildare ",285000,265000,20000,7.55,157,Kildare,Leinster
2240,2022-07-26," 1 Tullahill Grove, Tullahill, Loughrea, Galway ",275000,230000,45000,19.57,157,Galway,Connaught
2241,2022-07-26," 38 Seaview, Poulshone, Ardamine, Wexford ",260000,275000,-15000,-5.45,158,Wexford,Leinster
2242,2022-07-26," Burrane Lower , Killimer, Clare ",220000,240000,-20000,-8.33,158,Clare,Munster
2244,2022-07-26," Boheroe, Pallasgreen, Limerick ",125000,145000,-20000,-13.79,158,Limerick,Munster
2245,2022-07-26," 2 Dam Road, Carrigadrohid, Macroom, Cork ",425000,460000,-35000,-7.61,158,Cork,Munster
2246,2022-07-26," 8 Carrig Road, Ballymun, Dublin 11 ",189950,199950,-10000,-5.0,158,Dublin 11,Leinster
2247,2022-07-25," Tawley,Castlegal,Co. Leitrim,F91WA49 ",330000,360000,-30000,-8.33,158,Leitrim,Connaught
2248,2022-07-25," 3 Goose Green Acres,Killenagh,Gorey,Co. Wexford ",225000,275000,-50000,-18.18,158,Wexford,Leinster
2249,2022-07-25," 20 Brackenwood Avenue, Balbriggan,   County Dublin ",255000,260000,-5000,-1.92,158,Dublin,Leinster
2251,2022-07-25," Cartron East, Tullamore, Co. Offaly ",585000,645000,-60000,-9.3,158,Offaly,Leinster
2252,2022-07-25," House Type B. Castleview, Williamstown Road, Waterford City, Waterford ",695000,685000,10000,1.46,159,Waterford,Munster
2253,2022-07-25," House Type A. Castleview, Williamstown Road, Waterford City, Waterford ",655000,645000,10000,1.55,159,Waterford,Munster
2254,2022-07-25," Apartment 70 Block D Raven Hall Swords Central, Swords, County Dublin ",220000,225000,-5000,-2.22,159,Dublin,Leinster
2256,2022-07-25," 21 Upper Dublin Hill, Blackpool, Cork ",250000,280000,-30000,-10.71,159,Cork,Munster
2257,2022-07-25," 76 The Water Rill, Waterside, Malahide, Malahide,   County Dublin ",385000,370000,15000,4.05,159,Dublin,Leinster
2258,2022-07-25," Kiely's Butcher Shop, 31 Michael St, Waterford City, Waterford ",280000,310000,-30000,-9.68,159,Waterford,Munster
2260,2022-07-25," Jalna, Church Hill, Passage West, Cork ",249000,259000,-10000,-3.86,159,Cork,Munster
2261,2022-07-25," No. 11 Congress Tce, Longford, Longford ",159000,129000,30000,23.26,159,Longford,Leinster
2262,2022-07-25," 39 Oakdene, Heronswood, Carrigaline, Cork ",445000,465000,-20000,-4.3,159,Cork,Munster
2263,2022-07-25," 276 Crumlin Road, Crumlin, Dublin 12 ",425000,450000,-25000,-5.56,159,Dublin 12,Leinster
2264,2022-07-23," 5 Abbey View,The Lookout,Dungarvan,Co Waterford,X35AC94 ",345000,379000,-34000,-8.97,160,Waterford,Munster
2265,2022-07-23," Lislarkin South, Liscannor, Clare ",399000,450000,-51000,-11.33,160,Clare,Munster
2266,2022-07-23," 5 Latlurcan Close,Laturcan,Co. Monaghan ",205000,225000,-20000,-8.89,160,Monaghan,Ulster
2268,2022-07-23," Stoney Road,Oldcastle,Co.Meath,A82 AH67 ",199500,260000,-60500,-23.27,160,Meath,Leinster
2269,2022-07-22," Dunelm, South Mall, Lismore, Co. Waterford ",495000,435000,60000,13.79,160,Waterford,Munster
2270,2022-07-22," Murphy's Bay Cottage,Terryduff,Bofeenaun,Ballina,Co Mayo ",270000,285000,-15000,-5.26,160,Mayo,Connaught
2271,2022-07-22," 43 The Glebe,Ballina,Co Mayo,F26 P6E5 ",185000,195000,-10000,-5.13,160,Mayo,Connaught
2272,2022-07-22," Commercial and Residential,82 South Main,Bandon,Co. Cork ",360000,400000,-40000,-10.0,160,Cork,Munster
2273,2022-07-22," 11 Barry Park, Glanworth, Cork ",140000,130000,10000,7.69,160,Cork,Munster
2274,2022-07-22," 1 Luke Wadding Street, Waterford City, Co. Waterford, Waterford City, Waterford ",165000,195000,-30000,-15.38,160,Waterford,Munster
2275,2022-07-22," Letterard,Cashel,Connemara,Co.Galway,H91XNH7 ",145000,175000,-30000,-17.14,160,Galway,Connaught
2276,2022-07-22," The Bally Inn, Ballylaneen, Co. Waterford ",170000,220000,-50000,-22.73,160,Waterford,Munster
2277,2022-07-22," 83 Carrow Road, , Drimnagh, Dublin 12 ",290000,310000,-20000,-6.45,160,Dublin 12,Leinster
2278,2022-07-22," Ballygambon Lower, Cappagh, , Dungarvan, Waterford ",330000,299000,31000,10.37,161,Waterford,Munster
2279,2022-07-22," Pallashill, Drombane , Thurles, Tipperary ",150000,130000,20000,15.38,161,Tipperary,Munster
2280,2022-07-22," 16 The Mews, Castlerock, Midleton, Cork ",350000,375000,-25000,-6.67,161,Cork,Munster
2282,2022-07-21," Breaffa South,Spanish Point,Co. Clare,V95 X207 ",330000,349000,-19000,-5.44,161,Clare,Munster
2283,2022-07-21," Kingstown Glebe,Clifden,Co.Galway,H71 YY57 ",465000,495000,-30000,-6.06,161,Galway,Connaught
2284,2022-07-21," 1 Echo Avenue, Ballingarry, Co. Limerick ",225000,239000,-14000,-5.86,161,Limerick,Munster
2285,2022-07-21," 5 Bed Family Home, Blackrock Villas, Blackrock, Cork ",640000,495000,145000,29.29,161,Cork,Munster
2286,2022-07-21," Whitehall, Lisheen, Skibbereen, Cork ",300000,330000,-30000,-9.09,161,Cork,Munster
2287,2022-07-21," Ballykerin, Cappagh, Dungarvan, Waterford ",295000,350000,-55000,-15.71,161,Waterford,Munster
2288,2022-07-21," Lindal, Old Dublin Road, Stillorgan, Co. Dublin ",675000,745000,-70000,-9.4,161,Dublin,Leinster
2289,2022-07-21," 24 Richmond Wood, Riverstown, Glanmire, Cork ",175000,245000,-70000,-28.57,161,Cork,Munster
2290,2022-07-21," 49 Suncroft Park, Tallaght,   Dublin 24 ",225000,245000,-20000,-8.16,161,Dublin 24,Leinster
2291,2022-07-21," 28 Elsmore Grove, Naas, Co. Kildare ",460000,475000,-15000,-3.16,162,Kildare,Leinster
2293,2022-07-21," Cloonconlon,Straide,Foxford,Co. Mayo,F26 WN66 ",135000,149500,-14500,-9.7,162,Mayo,Connaught
2294,2022-07-21," Rock Business Centre,Upper Rock Street,Tralee,Co. Kerry,V92 WR9P ",315000,320000,-5000,-1.56,162,Kerry,Munster
2295,2022-07-20," 12 Elsmore Walk,Naas,Co. Kildare,W91 DD2T ",480000,495000,-15000,-3.03,162,Kildare,Leinster
2296,2022-07-20," 4 Castle St,Enniscorthy,Co. Wexford,Y21 HW92 ",190000,220000,-30000,-13.64,162,Wexford,Leinster
2297,2022-07-20," 123 Homefarm Road, Drumcondra,   Dublin 9 ",795000,875000,-80000,-9.14,162,Dublin 9,Leinster
2298,2022-07-20," 27 Rafters Road, Drimnagh, Dublin 12 ",249950,274950,-25000,-9.09,162,Dublin 12,Leinster
2299,2022-07-20," Ivy Cottage, Edenan and Kinclare, Ballinagare, Castlerea, Co. Roscommon ",55000,69000,-14000,-20.29,162,Roscommon,Connaught
2300,2022-07-20," Gardenhill, Castleconnell, Co. Limerick ",275000,300000,-25000,-8.33,162,Limerick,Munster
2302,2022-07-20," Setting Sun, Ballyhack, Arthurstown, Wexford ",399500,445000,-45500,-10.22,162,Wexford,Leinster
2303,2022-07-20," Lacknahacknee, Ballinagree, Macroom, Cork ",295000,315000,-20000,-6.35,162,Cork,Munster
2304,2022-07-20," Burnchurch Farm, Burnchurch, Cuffesgrange, Kilkenny ",250000,300000,-50000,-16.67,163,Kilkenny,Leinster
2305,2022-07-20," 9 Willow Park Road, Primrose Gate, Celbridge, Co. Kildare ",240000,249000,-9000,-3.61,163,Kildare,Leinster
2306,2022-07-20," 11 Racefield Centre, Fr. Russell Road, Limerick City, Limerick ",165000,175000,-10000,-5.71,163,Limerick,Munster
2307,2022-07-20," 35 Giltspur Brook, Bray, Co. Wicklow ",475000,495000,-20000,-4.04,163,Wicklow,Leinster
2308,2022-07-20," Church Street, Cahir, Tipperary ",240000,229000,11000,4.8,163,Tipperary,Munster
2309,2022-07-20," Grangeford, Bennekerry, Carlow Town, Carlow ",150000,189000,-39000,-20.63,163,Carlow,Leinster
2310,2022-07-20," Middleton Ardamine Courtown Gorey, Ardamine, Wexford ",220000,200000,20000,10.0,163,Wexford,Leinster
2311,2022-07-20," Valdemosa, Rougrane, Glounthaune, Cork ",315000,295000,20000,6.78,163,Cork,Munster
2313,2022-07-20," 3 Island Villas, South City Centre, Dublin 2 ",265000,295000,-30000,-10.17,163,Dublin 2,Leinster
2315,2022-07-20," 79 Swiftbrook Glen, Virginia, Cavan ",299500,290000,9500,3.28,163,Cavan,Ulster
2317,2022-07-19," 22 The Square, Drummin Village, Nenagh, Co. Tipperary ",199950,219950,-20000,-9.09,164,Tipperary,Munster
2318,2022-07-19," 11 Willville, Carlingford, Co. Louth ",389000,395000,-6000,-1.52,164,Louth,Leinster
2319,2022-07-19," Ballygerald,New Inn,Co Tipperary,E21VX96 ",170000,150000,20000,13.33,164,Tipperary,Munster
2320,2022-07-19," Apt 6 Applewood Square, Applewood Village, Swords, Co. Dublin ",235000,250000,-15000,-6.0,164,Dublin,Leinster
2321,2022-07-19," William Street, Portlaw, Co. Waterford ",124000,130000,-6000,-4.62,164,Waterford,Munster
2322,2022-07-19," Keeagh, Moycullen, Galway ",40000,60000,-20000,-33.33,164,Galway,Connaught
2323,2022-07-19,"  Breanabeg, Loughglynn, Roscommon ",110000,120000,-10000,-8.33,164,Roscommon,Connaught
2324,2022-07-19," Drumbee, Kilnaleck, Co Cavan ",35000,27000,8000,29.63,164,Cavan,Ulster
2325,2022-07-19," Lynn Road, Mullingar, Westmeath ",489950,525000,-35050,-6.68,164,Westmeath,Leinster
2326,2022-07-19," 34 Ashfield, Blackwater, Co. Wexford ",225000,249950,-24950,-9.98,164,Wexford,Leinster
2327,2022-07-19," Tigh Na Bruaich, Riverdale, Skibbereen, West Cork ",295000,320000,-25000,-7.81,164,Cork,Munster
2328,2022-07-19," Cappagh Stone House,Inistioge,Co. Kilkenny,R95 H9F6 ",975000,1200000,-225000,-18.75,164,Kilkenny,Leinster
2329,2022-07-19," 4 Castle Gate, Kennedy Street, Carlow Town, Carlow ",135000,150000,-15000,-10.0,164,Carlow,Leinster
2330,2022-07-19," 35 Edgeworth Court, Longwood, Meath ",315000,325000,-10000,-3.08,164,Meath,Leinster
2331,2022-07-19," 61 Cois Teampaill, Newcastle West, Limerick ",175000,185000,-10000,-5.41,164,Limerick,Munster
2332,2022-07-19,"  14 Redemption Road, City Centre Nth, Cork City ",250000,260000,-10000,-3.85,165,Cork,Munster
2333,2022-07-19," 18 Oak Brook, Tanyard Wood, Millstreet, Cork ",215000,195000,20000,10.26,165,Cork,Munster
2334,2022-07-19," Nivard House, Redgap, Monasterboice, Drogheda, Louth ",695000,750000,-55000,-7.33,165,Louth,Leinster
2336,2022-07-19," Cloonmorris, Gort, Galway ",95000,125000,-30000,-24.0,165,Galway,Connaught
2337,2022-07-19," Land @ Hobartstown East, Castledermot, Kildare ",150000,200000,-50000,-25.0,165,Kildare,Leinster
2338,2022-07-19," McDonagh's, On C. 0.6 Acre, Edward Street, Baltinglass, Wicklow ",395000,450000,-55000,-12.22,165,Wicklow,Leinster
2339,2022-07-19," 20 Walshs Terrace, Woodquay, City Centre, Galway City ",600000,450000,150000,33.33,165,Galway,Connaught
2340,2022-07-19," 7 & 7A Willowmount, Booterstown Avenue, Blackrock, County Dublin ",925000,985000,-60000,-6.09,165,Dublin,Leinster
2341,2022-07-19," Faha,Ring,Dungarvan,Co Waterford,X35XR57 ",385000,395000,-10000,-2.53,165,Waterford,Munster
2342,2022-07-18," 44 Killegland Hall, Ashbourne, Co. Meath ",215000,195000,20000,10.26,165,Meath,Leinster
2343,2022-07-18," 56 Lower Mount Carmel,New Ross,Co. Wexford,Y34 YC82 ",149000,165000,-16000,-9.7,165,Wexford,Leinster
2344,2022-07-18," Ballycannon,Kilcock,Co Kildare,W23 VKX4 ",850000,1075000,-225000,-20.93,165,Kildare,Leinster
2345,2022-07-18," 47 Cameron Square, Kilmainham, Dublin 8 ",375000,350000,25000,7.14,166,Dublin 8,Leinster
2346,2022-07-18," 37 Bushy Park Road, Rathgar,   Dublin 6 ",1800000,1950000,-150000,-7.69,166,Dublin 6,Leinster
2347,2022-07-18," 216 Cooley Road, Drimnagh, Dublin 12 ",335000,350000,-15000,-4.29,166,Dublin 12,Leinster
2348,2022-07-18," 1 Castletown Manor, Athboy, Meath ",440000,395000,45000,11.39,166,Meath,Leinster
2350,2022-07-18," Kilree, Bagenalstown, Carlow ",400000,425000,-25000,-5.88,166,Carlow,Leinster
2352,2022-07-18," Apartment 4, Kearn's Court, Kearn's Place, Kilmainham, Dublin 8 ",270000,280000,-10000,-3.57,166,Dublin 8,Leinster
2353,2022-07-18," Apt. 39 Centaur House, Centaur Street, Co. Carlow ",165000,169000,-4000,-2.37,166,Carlow,Leinster
2354,2022-07-18," Carricknagore, Bruckless, Donegal ",29000,35000,-6000,-17.14,166,Donegal,Ulster
2355,2022-07-18," 35 Dun Saithne Crescent,Balbriggan,Co. Dublin,K32 E796 ",229500,249500,-20000,-8.02,166,Dublin,Leinster
2356,2022-07-18," Unit 2B1B, JFK Industrial Estate, , Naas Road, Dublin 12 ",90000,80000,10000,12.5,166,Dublin 12,Leinster
2357,2022-07-18," Rampark, Jenkinstown, Co.Louth, Dundalk, Co. Louth ",289000,325000,-36000,-11.08,166,Louth,Leinster
2358,2022-07-18," 15 Mahon Drive, Blackrock, Cork ",245000,220000,25000,11.36,166,Cork,Munster
2359,2022-07-18," Knock Cross on  3 acres, Balrothery, County Dublin ",790000,830000,-40000,-4.82,166,Dublin,Leinster
2360,2022-07-18," 109 Altan, Western Distributor Road, Knocknacarra, Galway ",210000,200000,10000,5.0,167,Galway,Connaught
2361,2022-07-17," No. 97 Norwood Park, Cobh, Co Cork, Cobh, Cork ",340000,330000,10000,3.03,167,Cork,Munster
2362,2022-07-16," Unit & Ashbourne Manufacturing Park, Ashbourne, Co. Meath ",645000,495000,150000,30.3,167,Meath,Leinster
2363,2022-07-16," Loft 4, The Granary, Distillery Lofts, Drumcondra, Dublin 3 ",595000,675000,-80000,-11.85,167,Dublin 3,Leinster
2364,2022-07-16," 5 Coppinger Lane, Midleton, Cork ",180000,165000,15000,9.09,167,Cork,Munster
2365,2022-07-16," Kilnaborris,Banagher,Co. Galway ",155000,177000,-22000,-12.43,167,Galway,Connaught
2366,2022-07-16," 9 Gleann na Gcaor,Monageer,Enniscorthy,Co. Wexford,Y21XD36 ",235000,225000,10000,4.44,167,Wexford,Leinster
2367,2022-07-16," Rosewood House,Bulgan,Glynn,Co Wexford,Y21NX27 ",325000,350000,-25000,-7.14,167,Wexford,Leinster
2368,2022-07-16," 27 Dunavarra,Ballinakill Downs,Dunmore Road,Waterford.,X91 W6K8 ",425000,450000,-25000,-5.56,167,Waterford,Munster
2370,2022-07-15," 1 Willow Ridge, Gortnakesh, Cavan Town, Co. Cavan ",280000,275000,5000,1.82,167,Cavan,Ulster
2371,2022-07-15," Dunderrow, Kinsale, Cork ",140000,160000,-20000,-12.5,167,Cork,Munster
2372,2022-07-15," 173 Oakfield Heights, Naas, Co. Kildare ",295000,310000,-15000,-4.84,167,Kildare,Leinster
2373,2022-07-15," 135 Bannow Road, Cabra West, Cabra, Dublin ",275000,295000,-20000,-6.78,167,Dublin,Leinster
2374,2022-07-15," Knockgrania, Bunninadden, , South Sligo, Sligo ",57500,75000,-17500,-23.33,168,Sligo,Connaught
2375,2022-07-15," Grange Little, Rosslare Strand, Co. Wexford ",350000,300000,50000,16.67,168,Wexford,Leinster
2376,2022-07-15," Beakstown, Thurles, Tipperary ",320000,370000,-50000,-13.51,168,Tipperary,Munster
2377,2022-07-15," Sligo Road, Tubbercurry, Sligo ",50000,45000,5000,11.11,168,Sligo,Connaught
2378,2022-07-15," Cavan Road, Virginia, Cavan ",350000,425000,-75000,-17.65,168,Cavan,Ulster
2379,2022-07-15," 36 Bulfin Road, Inchicore, Dublin 8 ",710000,450000,260000,57.78,168,Dublin 8,Leinster
2381,2022-07-15," 10 Williamstown Village, Williamstown, Waterford., Waterford City, Waterford ",435000,460000,-25000,-5.43,168,Waterford,Munster
2382,2022-07-15," Coolbeg, Kildimo, Co. Limerick ",149000,169000,-20000,-11.83,168,Limerick,Munster
2383,2022-07-15," 28 Woodbine Way, Kinsalebeg, Waterford ",215000,200000,15000,7.5,168,Waterford,Munster
2384,2022-07-15," 38 Silverglen, Mountmellick, Laois ",195000,205000,-10000,-4.88,168,Laois,Leinster
2386,2022-07-14," Ebb Tide,Doogans Warren,Rosslare Strand,Co Wexford,Y35X981 ",495000,650000,-155000,-23.85,168,Wexford,Leinster
2387,2022-07-14," Meadstown,Dunderry,Co Meath,C15 A566 ",300000,350000,-50000,-14.29,168,Meath,Leinster
2388,2022-07-14," 14 Wheaton Court, INCHICORE TERRACE NORTH, Inchicore, Dublin 8 ",289950,300000,-10050,-3.35,168,Dublin 8,Leinster
2389,2022-07-14," 15 Connawood Way, Old Connawood, Bray, Co. Wicklow ",525000,495000,30000,6.06,169,Wicklow,Leinster
2390,2022-07-14," Apartment 5a Church Crescent, Athy, Kildare ",180000,190000,-10000,-5.26,169,Kildare,Leinster
2391,2022-07-14," The Cart House, Ballyvalloo, Curracloe, Co. Wexford ",250000,220000,30000,13.64,169,Wexford,Leinster
2392,2022-07-14," 4 New Street North, Smithfield, Dublin 7 ",280000,275000,5000,1.82,169,Dublin 7,Leinster
2393,2022-07-14," 88 The Gallery , Donabate, County Dublin ",420000,475000,-55000,-11.58,169,Dublin,Leinster
2394,2022-07-14," Coarsepark, Headford, Co Galway, Headford, Galway ",40000,32500,7500,23.08,169,Galway,Connaught
2395,2022-07-14," 37 Richmond Park, Monkstown, County Dublin ",595000,635000,-40000,-6.3,169,Dublin,Leinster
2396,2022-07-14," Templemartin, Clara, Co. Kilkenny ",295000,320000,-25000,-7.81,169,Kilkenny,Leinster
2397,2022-07-14," Three Bedroom Corner House, 4 Millbank,, Blessington, Wicklow ",389000,395000,-6000,-1.52,169,Wicklow,Leinster
2398,2022-07-14," 11 Infirmary Road , Stoneybatter, Dublin 7 ",450000,485000,-35000,-7.22,169,Dublin 7,Leinster
2399,2022-07-14," 8 Orlagh Grange, Knocklyon, Dublin 16 ",495000,475000,20000,4.21,170,Dublin 16,Leinster
2400,2022-07-14," 85 College Orchard, Newbridge, Kildare ",280000,300000,-20000,-6.67,170,Kildare,Leinster
2401,2022-07-14," 26 Michael Street, Kilkenny, Kilkenny ",275000,285000,-10000,-3.51,170,Kilkenny,Leinster
2402,2022-07-14," 23 Mayfield Grove,Athlone,Co. Westmeath,N37XY19 ",395000,385000,10000,2.6,170,Westmeath,Leinster
2403,2022-07-14," Lisreagh,Cavan,H12 W018 ",390000,350000,40000,11.43,170,Cavan,Ulster
2404,2022-07-13," Main Street, Mountrath, Co. Laois ",165000,175000,-10000,-5.71,170,Laois,Leinster
2405,2022-07-13," 1 Newbrook Avenue, Donaghmede, Dublin 13, Dublin ",377750,379950,-2200,-0.58,170,Dublin,Leinster
2407,2022-07-13," Clonervy Poles, Cavan, Cavan ",45000,50000,-5000,-10.0,170,Cavan,Ulster
2409,2022-07-13," Kilmallock Road , Charleville, Cork ",185000,220000,-35000,-15.91,170,Cork,Munster
2410,2022-07-13," Ballyline West, BallyLongford, Kerry ",105000,135000,-30000,-22.22,170,Kerry,Munster
2411,2022-07-13," Saint Ritas, School Road, Castlegar, Co. Galway ",360000,375000,-15000,-4.0,170,Galway,Connaught
2413,2022-07-12," 11 Carrigmore,Caherslee,Tralee,Co Kerry,V92 Y2HY ",580000,360000,220000,61.11,171,Kerry,Munster
2414,2022-07-12," 69 Gleann Riada,Longford,N39X3W8 ",117500,112500,5000,4.44,171,Longford,Leinster
2415,2022-07-12," NO. 10 Shingan, Enniscorthy, Co. Wexford ",219950,235000,-15050,-6.4,171,Wexford,Leinster
2417,2022-07-12," 69 Embassy Manor, Kill, Kildare ",349000,359000,-10000,-2.79,171,Kildare,Leinster
2418,2022-07-12," Tooreeny, Moycullen, Co. Galway ",510000,525000,-15000,-2.86,171,Galway,Connaught
2419,2022-07-12," 61a Rossmore Park , Newtownmountkennedy, Wicklow ",575000,595000,-20000,-3.36,171,Wicklow,Leinster
2420,2022-07-12," 200 Belmont, Bray, Wicklow ",390000,395000,-5000,-1.27,171,Wicklow,Leinster
2421,2022-07-12," Hollyoak, 7 Millbank, Killincarrig, Greystones, Wicklow ",745000,795000,-50000,-6.29,171,Wicklow,Leinster
2422,2022-07-12," 1 Glandore Court, Dun Laoghaire, County Dublin ",395000,425000,-30000,-7.06,171,Dublin,Leinster
2425,2022-07-12," House Type F ,Leighton Manor, Two Mile Borris, Thurles, Tipperary ",340000,285000,55000,19.3,172,Tipperary,Munster
2426,2022-07-12," House Type E Leighton Manor, Two Mile Borris, Thurles, Tipperary ",365000,325000,40000,12.31,172,Tipperary,Munster
2427,2022-07-12," House Type B Leighton Manor, Two Mile Borris, Thurles, Tipperary ",420000,365000,55000,15.07,172,Tipperary,Munster
2428,2022-07-12," 1 Shore Court, Omeath, Co. Louth ",185000,195000,-10000,-5.13,172,Louth,Leinster
2429,2022-07-12," 5 Ozier Grove, Mauritiustown, Rosslare Strand, Co. Wexford ",249000,245000,4000,1.63,172,Wexford,Leinster
2430,2022-07-12," Apt. 15 Seapoint Court, Bray, Wicklow ",325000,299000,26000,8.7,172,Wicklow,Leinster
2432,2022-07-12," Moin Na Ri, Kilworth, Cork ",425000,450000,-25000,-5.56,172,Cork,Munster
2433,2022-07-12," Ballinapark, Bunclody, Enniscorthy, Co. Wexford ",250000,225000,25000,11.11,172,Wexford,Leinster
2434,2022-07-12," 6 Lakeview, Virginia, Cavan ",500000,550000,-50000,-9.09,172,Cavan,Ulster
2435,2022-07-12," Lenamarla, Creggs, Co. Galway ",90000,95000,-5000,-5.26,172,Galway,Connaught
2437,2022-07-12," Croagh Phadraig, Ducketts Grove, Palatine, Carlow ",449000,435000,14000,3.22,172,Carlow,Leinster
2438,2022-07-12," ""Ballywilliam House”, Ballywilliam, Kinsale, Cork ",2300000,2500000,-200000,-8.0,172,Cork,Munster
2439,2022-07-12," Ballinatray , Courtown, Wexford ",90000,99000,-9000,-9.09,172,Wexford,Leinster
2440,2022-07-12," Whitewood, Kilmainhamwood, Kells, Meath ",45000,55000,-10000,-18.18,173,Meath,Leinster
2441,2022-07-12," 9 Derg View, Scarriff, Clare ",170000,195000,-25000,-12.82,173,Clare,Munster
2442,2022-07-12," 93 Tournore Court,Abbeyside,Dungarvan,Co Waterford,X35YH72 ",345000,365000,-20000,-5.48,173,Waterford,Munster
2443,2022-07-12," Apartment 7, Curragh Hall House, Curragh Hall Crescent, Tyrrelstown, Dublin 15 ",209950,189950,20000,10.53,173,Dublin 15,Leinster
2444,2022-07-12," 56 The Crescent, Carrickmines Manor, Carrickmines, Dublin 18 ",395000,375000,20000,5.33,173,Dublin 18,Leinster
2445,2022-07-11," 1a The Quay,Cheekpoint,Waterford ",145000,98000,47000,47.96,173,Waterford,Munster
2446,2022-07-11," Coolnagour,Milford,Charleville,Co. Cork,P56 HH95 ",130000,125000,5000,4.0,173,Cork,Munster
2451,2022-07-11," Bay Meadows, Ballykea, Skerries,   County Dublin ",600000,650000,-50000,-7.69,173,Dublin,Leinster
2452,2022-07-11," Hill View, Bishopswood Road, Portarlington, Laois ",325000,349000,-24000,-6.88,173,Laois,Leinster
2453,2022-07-11," ""Sancta Maria"" 24 Main Street, Carnew, Wicklow ",339000,399000,-60000,-15.04,174,Wicklow,Leinster
2454,2022-07-11," 12 La Touche Cove, Cliff Road, Greystones, Co. Wicklow, Greystones, Wicklow ",1180000,1170000,10000,0.85,174,Wicklow,Leinster
2456,2022-07-11," 71 Belmont Avenue, Donnybrook, Dublin 4 ",1000000,995000,5000,0.5,174,Dublin 4,Leinster
2457,2022-07-11," 737A Lodgepark , Straffan, Kildare ",85000,70000,15000,21.43,174,Kildare,Leinster
2458,2022-07-11," 4 Woodbrook Park, Templeogue, Dublin 16 ",750000,795000,-45000,-5.66,174,Dublin 16,Leinster
2459,2022-07-11," 46 Montrose Grove, Artane, Dublin 5 ",425000,395000,30000,7.59,174,Dublin 5,Leinster
2460,2022-07-11," 36 Morrison Terrace, Ballina, Mayo ",130000,150000,-20000,-13.33,174,Mayo,Connaught
2462,2022-07-11," 19 Branogue Park, Riverchapel, Gorey, Wexford ",225000,245000,-20000,-8.16,174,Wexford,Leinster
2463,2022-07-11," Castle Park, Killycard, Castleblayney, Monaghan ",279000,275000,4000,1.45,174,Monaghan,Ulster
2464,2022-07-10," 5 Dún Na Carraige, Kingscourt, Cavan ",250000,249000,1000,0.4,174,Cavan,Ulster
2465,2022-07-09," 5 Mount View, Kingscourt, Cavan ",250000,249000,1000,0.4,174,Cavan,Ulster
2467,2022-07-08," Ballylacey,Gorey,Co. Wexford,Y25R2W7 ",599000,625000,-26000,-4.16,174,Wexford,Leinster
2468,2022-07-08," 52 The Lodge,Abbeylands,Clane,Co Kildare,W91 KC43 ",225000,240000,-15000,-6.25,174,Kildare,Leinster
2469,2022-07-08," Oakwood, Redcross, Co. Wicklow ",265000,290000,-25000,-8.62,175,Wicklow,Leinster
2470,2022-07-08," 9 Prospect Drive,Brooklawns,First Sea Road,Sligo ",229000,205000,24000,11.71,175,Sligo,Connaught
2471,2022-07-08," Site 9 With Outline Planning,Holland Drive,Liscannor,Co Clare ",125000,120000,5000,4.17,175,Clare,Munster
2472,2022-07-08," 31 Ocean Point, Courtown, Wexford ",188000,199000,-11000,-5.53,175,Wexford,Leinster
2473,2022-07-08," 29 Middletown Valley, Riverchapel, Gorey, Wexford ",275000,270000,5000,1.85,175,Wexford,Leinster
2474,2022-07-08," 178 Branswood , Athy, Kildare ",260000,270000,-10000,-3.7,175,Kildare,Leinster
2477,2022-07-08," 29 Thomas Davis Street West, Inchicore, Dublin 8 ",335000,295000,40000,13.56,175,Dublin 8,Leinster
2478,2022-07-08," Carraghy, Knockdoe, Claregalway, Co. Galway ",50000,70000,-20000,-28.57,175,Galway,Connaught
2479,2022-07-08," Spring Lodge, Ballyard, Tralee, Kerry ",290000,280000,10000,3.57,175,Kerry,Munster
2481,2022-07-08," 21 O'Curry Road, South Circular Road, Dublin 8 ",475000,545000,-70000,-12.84,175,Dublin 8,Leinster
2482,2022-07-08," Poulpeasty,Clonroche,Co Wexford,Y21 V0Y5 ",200000,220000,-20000,-9.09,176,Wexford,Leinster
2483,2022-07-08," Pottlebane,Carnaross,Kells,Co Meath,A82 HW54 ",365000,350000,15000,4.29,176,Meath,Leinster
2484,2022-07-07," Cappauniac, Cahir, Tipperary ",375000,325000,50000,15.38,176,Tipperary,Munster
2485,2022-07-07," Bell`s Grocery Shop, Kilsaran, Dundalk, Co. Louth ",175000,150000,25000,16.67,176,Louth,Leinster
2486,2022-07-07," 13 Ferncarrig Avenue, Sandyford, Dublin 18 ",650000,595000,55000,9.24,176,Dublin 18,Leinster
2488,2022-07-07," 4 Edenhill, The Loakers, Blackrock, Dundalk, Co. Louth ",195000,200000,-5000,-2.5,176,Louth,Leinster
2489,2022-07-07," 17 Harbour Cottages, Carlingford, Dundalk, Co. Louth ",220000,240000,-20000,-8.33,176,Louth,Leinster
2491,2022-07-07," Calveagh Lower, Carracastle, Ballaghaderreen, Castlerea, Co. Roscommon ",100000,150000,-50000,-33.33,176,Roscommon,Connaught
2492,2022-07-07," 2 Lake Grove, Kilminchy, Portlaoise, Laois ",199000,219000,-20000,-9.13,176,Laois,Leinster
2493,2022-07-07," 21 Coole Haven , Gort, Galway ",130000,145000,-15000,-10.34,177,Galway,Connaught
2494,2022-07-07," 185 Ashlawn Park, Ballybrack, Dublin South ",375000,390000,-15000,-3.85,177,Dublin,Leinster
2495,2022-07-07," 25 Weavers Hall, Levmoss Park, Leopardstown, Dublin 18 ",395000,340000,55000,16.18,177,Dublin 18,Leinster
2496,2022-07-07," Apartment 29, Torquay, Castle Court, Kilgobbin Wood, Sandyford, Dublin 18 ",325000,375000,-50000,-13.33,177,Dublin 18,Leinster
2497,2022-07-07," Ardfarna, Bundoran, Donegal ",495000,525000,-30000,-5.71,177,Donegal,Ulster
2498,2022-07-07," Cocks Lane Irishtown, Gormanston, Meath ",299950,390000,-90050,-23.09,177,Meath,Leinster
2499,2022-07-07," Briar Hill House, Scarteen Road, Newmarket, Cork ",220000,245000,-25000,-10.2,177,Cork,Munster
2500,2022-07-07," 8 Coolaghknock Avenue, Kildare Town, Kildare ",275000,300000,-25000,-8.33,177,Kildare,Leinster
2501,2022-07-07," 7 The Tanager, Barnagerragh, Skerries,   County Dublin ",485000,500000,-15000,-3.0,177,Dublin,Leinster
2502,2022-07-07," 4 Barons Way, Lismullen Grove, Armagh Road, Dundalk, Louth ",172000,185000,-13000,-7.03,177,Louth,Leinster
2503,2022-07-07," 94 Brooklands, Clane, Kildare ",299000,315000,-16000,-5.08,177,Kildare,Leinster
2504,2022-07-07," * Last Bungalow at Fairfield Road *, Glasnevin, Dublin 9 ",535000,575000,-40000,-6.96,177,Dublin 9,Leinster
2506,2022-07-07," 7 Charter Hall,Trim,Co Meath ",175000,195000,-20000,-10.26,177,Meath,Leinster
2507,2022-07-06," Woodtown , Drumconrath, Meath ",375000,450000,-75000,-16.67,177,Meath,Leinster
2508,2022-07-06," Rossbeigh, 15 Castlewoods, Ballinamona, Co. Waterford ",775000,825000,-50000,-6.06,178,Waterford,Munster
2510,2022-07-06," 201 Cashel Road, Crumlin, Dublin 12 ",295000,315000,-20000,-6.35,178,Dublin 12,Leinster
2511,2022-07-06," 48 Lios an Uisce, Renmore, Galway ",268000,300000,-32000,-10.67,178,Galway,Connaught
2512,2022-07-06," 67 Ard Alainn, Castlebridge, Co. Wexford ",190000,200000,-10000,-5.0,178,Wexford,Leinster
2513,2022-07-06," Dore Upper, Bunbeg, Donegal ",220000,230000,-10000,-4.35,178,Donegal,Ulster
2514,2022-07-06," 94 Crann Nua, Portarlington, Laois ",269000,285000,-16000,-5.61,178,Laois,Leinster
2515,2022-07-06," Lands at Toghernacross, Kilcogy, Cavan ",42000,56000,-14000,-25.0,178,Cavan,Ulster
2517,2022-07-06," 2 Knockbarry Cottages, Buttevant, Cork ",110000,149000,-39000,-26.17,178,Cork,Munster
2518,2022-07-06," 4 Marie Place, City Centre Sth,   Cork City ",195000,215000,-20000,-9.3,178,Cork,Munster
2519,2022-07-06," 77 Hunters Walk, Ballycullen, Dublin 24 ",399950,420000,-20050,-4.77,178,Dublin 24,Leinster
2520,2022-07-06," Rossbeigh, 15 Castlewoods, Waterford City, Waterford ",775000,825000,-50000,-6.06,178,Waterford,Munster
2523,2022-07-06," 41 Castle Heights, Carrick On Suir, Co.Tipperary, Carrick-on-Suir, Co. Tipperary ",190000,199000,-9000,-4.52,179,Tipperary,Munster
2524,2022-07-06," 20 St Brigid's Square, Portarlington, Laois ",165000,185000,-20000,-10.81,179,Laois,Leinster
2526,2022-07-06," 44 Kilmainham Bank, Kilmainham, Dublin 8 ",270000,225000,45000,20.0,179,Dublin 8,Leinster
2527,2022-07-06," 19 Silverpines, Tullow Rd, Carlow Town, Carlow ",300000,279000,21000,7.53,179,Carlow,Leinster
2528,2022-07-06," 3 Ballymanus Court, Glenealy, Wicklow ",315000,325000,-10000,-3.08,179,Wicklow,Leinster
2529,2022-07-06," 10 Orby Way, Leopardstown, Dublin 18 ",575000,595000,-20000,-3.36,179,Dublin 18,Leinster
2530,2022-07-06," Bellair, Clonaslee, Laois ",280000,295000,-15000,-5.08,179,Laois,Leinster
2531,2022-07-06," 29 Hollybank Way, Clongowen, Kilkenny, Kilkenny ",290000,295000,-5000,-1.69,179,Kilkenny,Leinster
2532,2022-07-06," 13 Fortunestown Close, Tallaght, Dublin 24 ",275000,285000,-10000,-3.51,179,Dublin 24,Leinster
2533,2022-07-06," 81 Eallagh, Headford, Galway ",280000,295000,-15000,-5.08,179,Galway,Connaught
2534,2022-07-06," 18 Abbey Cresent, Ballyroan Road, Abbeyleix, Laois ",260000,300000,-40000,-13.33,179,Laois,Leinster
2536,2022-07-06," 12 Putland Villas, Vevay Road, Bray, Co. Wicklow ",599000,635000,-36000,-5.67,179,Wicklow,Leinster
2537,2022-07-06," Crannagh, Mountrath, Laois ",200000,250000,-50000,-20.0,179,Laois,Leinster
2538,2022-07-06," 1 Hawthorn Close, East Wall, Dublin 3 ",550000,570000,-20000,-3.51,179,Dublin 3,Leinster
2539,2022-07-06," 14 Newlands Manor Park, Clondalkin, Dublin ",245000,240000,5000,2.08,180,Dublin,Leinster
2540,2022-07-06," 9 Priory Court,New Ross,Co. Wexford,Y34 AX68 ",129000,149000,-20000,-13.42,180,Wexford,Leinster
2541,2022-07-05," 54 Hazelwood,Bridgetown,Co. Wexford,Y35 DW72 ",122500,125000,-2500,-2.0,180,Wexford,Leinster
2542,2022-07-05," 10A  Ashfield Drive, Ballinasloe, Galway ",185000,195000,-10000,-5.13,180,Galway,Connaught
2544,2022-07-05," 7 Sarsfield St, Clonmel, Co. Tipperary ",200000,250000,-50000,-20.0,180,Tipperary,Munster
2545,2022-07-05," 9 Chapel Mews, Sallins, Kildare ",175000,180000,-5000,-2.78,180,Kildare,Leinster
2546,2022-07-05," 18 Egmont Woods,Kanturk,Co. Cork,P51 Y9N7 ",335000,315000,20000,6.35,180,Cork,Munster
2548,2022-07-05," Carraig Mor House,Maudlintown,Wexford,Y35E6W4 ",475000,595000,-120000,-20.17,180,Wexford,Leinster
2550,2022-07-05," 7 Roschoill, Pallaskenry, Limerick ",240000,250000,-10000,-4.0,180,Limerick,Munster
2551,2022-07-05," 4 Ashford Cottages, Stoneybatter, Dublin 7 ",285000,310000,-25000,-8.06,180,Dublin 7,Leinster
2552,2022-07-05," 76 Bow Bridge Place, Kilmainham, Dublin 8 ",245000,195000,50000,25.64,181,Dublin 8,Leinster
2553,2022-07-05," 109 Marina Village, Malahide, Dublin ",375000,395000,-20000,-5.06,181,Dublin,Leinster
2554,2022-07-05," Apartment 5, Glenfin Court, Glenfin Road, Ballybofey, Co. Donegal ",95000,99000,-4000,-4.04,181,Donegal,Ulster
2555,2022-07-05," Callan, Drumkeen, Co. Donegal ",520000,490000,30000,6.12,181,Donegal,Ulster
2558,2022-07-05," 22 Skibbereen Retirement Village, Baltimore Road, Skibbereen,   West Cork ",145000,125000,20000,16.0,181,Cork,Munster
2559,2022-07-05," 29 Church Street, Templemore, Tipperary ",140000,148000,-8000,-5.41,181,Tipperary,Munster
2562,2022-07-04," 4 The Belfry,Athboy Road,Trim,Co Meath,C15 YK13 ",425000,450000,-25000,-5.56,181,Meath,Leinster
2563,2022-07-04," Site At Boher,Ballycumber,Co Offaly ",40000,50000,-10000,-20.0,181,Offaly,Leinster
2564,2022-07-04," 723 Courtown Road,Kilcock,Co. Kildare,W23 NH10 ",260000,295000,-35000,-11.86,181,Kildare,Leinster
2565,2022-07-04," 43 St Peters Road, Bray, Wicklow ",299000,300000,-1000,-0.33,182,Wicklow,Leinster
2566,2022-07-04," 177 The Berkeley, Pembroke Square, Ballsbridge, Dublin 4 ",460000,475000,-15000,-3.16,182,Dublin 4,Leinster
2567,2022-07-04," Carrickavoher,Aughavas,Co.  Leitrim,H12 XF60 ",150000,180000,-30000,-16.67,182,Leitrim,Connaught
2568,2022-07-04," Greenmount,Clonhaston,Enniscorthy,Co Wexford,Y21 X9K1 ",220000,250000,-30000,-12.0,182,Wexford,Leinster
2570,2022-07-04," Sunville, Claureen, Ennis, Clare ",300000,330000,-30000,-9.09,182,Clare,Munster
2571,2022-07-04," Ivy Cottage, Ballyfrory, Duncormick, Wexford ",220000,245000,-25000,-10.2,182,Wexford,Leinster
2573,2022-07-04," 52 Carrigcourt, Carrigaline, Cork ",450000,440000,10000,2.27,182,Cork,Munster
2575,2022-07-04," 73 Tower Street, City Centre Sth, Cork City ",150000,170000,-20000,-11.76,182,Cork,Munster
2576,2022-07-04," 59 Corabbey Court, Midleton, Cork ",175000,170000,5000,2.94,182,Cork,Munster
2578,2022-07-04," River Road, Spiddal, Co. Galway ",90000,125000,-35000,-28.0,183,Galway,Connaught
2579,2022-07-04," 12 Francis Street, Ballybricken, Waterford City, Waterford ",275000,235000,40000,17.02,183,Waterford,Munster
2581,2022-07-03," Ardnamullen, Clonard, Meath ",95000,140000,-45000,-32.14,183,Meath,Leinster
2582,2022-07-02," Knockshanballey,Straide,Foxford,Co. Mayo ",68000,75000,-7000,-9.33,183,Mayo,Connaught
2583,2022-07-02," 3 Tur Dubhain,Churchtown,Fethard On Sea,Co. Wexford,Y34 EN22 ",379000,395000,-16000,-4.05,183,Wexford,Leinster
2584,2022-07-01," 3 Reenmeen Woods,Glengarriff,Co Cork,P75 E431 ",369000,395000,-26000,-6.58,183,Cork,Munster
2585,2022-07-01," Glebe Lodge,Church Strand,Baltimore,Co. Cork,P81 TX44 ",295000,395000,-100000,-25.32,183,Cork,Munster
2586,2022-07-01," 16 Ardgillen Drive, Balbriggan, Balbriggan, County Dublin ",325000,355000,-30000,-8.45,183,Dublin,Leinster
2587,2022-07-01," 4 The Courtyard, Drogheda, Louth ",180000,200000,-20000,-10.0,183,Louth,Leinster
2588,2022-07-01," Ard na Greinne, Lettertrain, Letterbarrow, Donegal Town, Donegal ",265000,280000,-15000,-5.36,183,Donegal,Ulster
2589,2022-07-01," APT.2 LINNBLA, SANTRY CROSS, Ballymun, Dublin 11 ",165000,175000,-10000,-5.71,184,Dublin 11,Leinster
2590,2022-07-01," No. 14 Kennedy Gardens, Castlebar, Mayo ",180000,175000,5000,2.86,184,Mayo,Connaught
2591,2022-07-01," 10 Mill Court Avenue, Clondalkin, Dublin 22 ",265000,275000,-10000,-3.64,184,Dublin 22,Leinster
2592,2022-07-01," 33 Kilderry Hall, Ashbourne, Meath ",225000,220000,5000,2.27,184,Meath,Leinster
2594,2022-07-01," Callan, Drumkeen, Donegal ",520000,500000,20000,4.0,184,Donegal,Ulster
2595,2022-07-01," 51 Bayview Drive, Killiney, County Dublin, A96 T667 ",495000,490000,5000,1.02,184,Dublin,Leinster
2596,2022-07-01," 1 Fortlands, Sligo Road, Ballaghaderreen, Roscommon ",179000,195000,-16000,-8.21,184,Roscommon,Connaught
2597,2022-07-01," 131 Rosehill, Wicklow Town, Co. Wicklow ",365000,375000,-10000,-2.67,184,Wicklow,Leinster
2598,2022-07-01," 15 Rossa Street, Clonakilty,   West Cork ",395000,275000,120000,43.64,184,Cork,Munster
2599,2022-07-01," 130 Fearann Ri, Doughiska, Galway City ",245000,257500,-12500,-4.85,184,Galway,Connaught
2600,2022-07-01," 16 Clós na Croise, Ballivor, Meath ",199950,224950,-25000,-11.11,184,Meath,Leinster
2603,2022-07-01," Land @ Rathvinden, Leighlinbridge, Carlow ",500000,400000,100000,25.0,185,Carlow,Leinster
2604,2022-07-01," Downstown, Duleek, Meath, A92 YR29 ",335000,325000,10000,3.08,185,Meath,Leinster
2605,2022-07-01," 71 Northlands, Bettystown, Meath ",269000,289000,-20000,-6.92,185,Meath,Leinster
2606,2022-07-01," Dunworley Farmhouse,Lissycremin,Bandon,Co Cork,P72 V993 ",625000,435000,190000,43.68,185,Cork,Munster
2608,2022-06-30," 63, Castleglen, Mornington, Meath ",295000,320000,-25000,-7.81,185,Meath,Leinster
2609,2022-06-30," 19A Tim Daly Terrace,Midleton,Co Cork,P25 VW18 ",329000,275000,54000,19.64,185,Cork,Munster
2612,2022-06-30," Knightswood, Matthews Lane, Drogheda, Meath ",330000,345000,-15000,-4.35,185,Meath,Leinster
2614,2022-06-30," 36 Kiltipper Drive, Aylesbury, Dublin 24 ",385000,295000,90000,30.51,186,Dublin 24,Leinster
2615,2022-06-30," 116 Cromcastle Road, Kilmore, Dublin ",275000,295000,-20000,-6.78,186,Dublin,Leinster
2617,2022-06-30," Fairview, Reen, Union Hall, Cork ",790000,800000,-10000,-1.25,186,Cork,Munster
2618,2022-06-30," John Joe Sheehy Road, Tralee, Kerry ",295000,270000,25000,9.26,186,Kerry,Munster
2619,2022-06-30," Tignabruagh, Saintbury Avenue, Killiney, Co. Dublin ",1000000,1150000,-150000,-13.04,186,Dublin,Leinster
2620,2022-06-30," 7 Somerville Apartments, Ramparts, Dundalk, Co. Louth ",135000,150000,-15000,-10.0,186,Louth,Leinster
2622,2022-06-30," For Sale, Leasehold Interest, Restaurant Opportunity , Clontarf, Dublin 3 ",275000,250000,25000,10.0,186,Dublin 3,Leinster
2623,2022-06-30," 40 Cluain Shee, Aikens Village, Sandyford, Dublin 18 ",485000,495000,-10000,-2.02,186,Dublin 18,Leinster
2624,2022-06-30," 157 St John's Crescent, Clondalkin,   Dublin 22 ",270000,280000,-10000,-3.57,186,Dublin 22,Leinster
2626,2022-06-30," 59 Glentow Road, Santry, Dublin 9, Santry, Dublin 9 ",379000,389000,-10000,-2.57,186,Dublin 9,Leinster
2629,2022-06-30," No. 8 Assumption place, cobh, co cork , Cobh, East Cork ",250000,275000,-25000,-9.09,186,Cork,Munster
2630,2022-06-29," Ross House,Screggan,Tullamore,Co Offaly,R35 P959 ",800000,700000,100000,14.29,186,Offaly,Leinster
2631,2022-06-29," 28 Berry's Court, Inchicore, Dublin 8 ",300000,275000,25000,9.09,187,Dublin 8,Leinster
2632,2022-06-29," 6 Rocksprings, Dunmore Road, Co. Waterford ",795000,850000,-55000,-6.47,187,Waterford,Munster
2633,2022-06-29," 27 The Glen, Coosan, Athlone, Co. Westmeath ",229000,249000,-20000,-8.03,187,Westmeath,Leinster
2634,2022-06-29," 71 Granville Road, Dun Laoghaire, Co. Dublin ",680000,690000,-10000,-1.45,187,Dublin,Leinster
2636,2022-06-29," The Cottage, Convent Lane, Rush, Dublin ",395000,420000,-25000,-5.95,187,Dublin,Leinster
2637,2022-06-29," 13 Maple Wood, Pembroke Wood, Passage West, Cork ",295000,315000,-20000,-6.35,187,Cork,Munster
2638,2022-06-29," 19 Portobello Quay, Portobello Harbour, Portobello, Dublin 8 ",495000,515000,-20000,-3.88,187,Dublin 8,Leinster
2640,2022-06-29," 43 Cois Croinn, Saltown, Dundalk, Co. Louth ",145000,135000,10000,7.41,187,Louth,Leinster
2641,2022-06-29," Ballyheaphy, Araglin, Kilworth, Cork ",342500,365000,-22500,-6.16,187,Cork,Munster
2642,2022-06-29," 47 Ascal a Do, Yellowbatter, Drogheda, Louth ",220000,210000,10000,4.76,187,Louth,Leinster
2643,2022-06-29," Seamount, Balscadden Road, Howth, County Dublin ",2250000,2125000,125000,5.88,187,Dublin,Leinster
2644,2022-06-29," Ballylinch, Baltimore, Cork ",295000,275000,20000,7.27,187,Cork,Munster
2645,2022-06-29," 19 Pinewoods, Westport, Mayo ",150000,180000,-30000,-16.67,188,Mayo,Connaught
2646,2022-06-29," Ballyduff, Camolin, Wexford ",60000,65000,-5000,-7.69,188,Wexford,Leinster
2647,2022-06-29," Ballintemple,Meelick,Swinford,Co Mayo,F12X296 ",129000,139000,-10000,-7.19,188,Mayo,Connaught
2649,2022-06-29," Ref 967 - Naomh Brigid, Knockeens, Caherciveen, Kerry ",398500,497000,-98500,-19.82,188,Kerry,Munster
2650,2022-06-29," 28 Hybreasal House, Kilmainham, Dublin 8 ",255000,225000,30000,13.33,188,Dublin 8,Leinster
2651,2022-06-29," Apt 53 Trimleston,Balbriggan,Co. Dublin,K32 C667 ",200000,215000,-15000,-6.98,188,Dublin,Leinster
2654,2022-06-28," 36 Cartrun Breac, Longford, Longford ",114500,119500,-5000,-4.18,188,Longford,Leinster
2655,2022-06-28," 167 Hunters Green, Hunterswood, Ballycullen,   Dublin 24 ",275000,300000,-25000,-8.33,188,Dublin 24,Leinster
2656,2022-06-28," 'Cali' Ard Mhuire Park, Dalkey, County Dublin ",1550000,1700000,-150000,-8.82,188,Dublin,Leinster
2657,2022-06-28," 23 Castleview Crescent, Swords, County Dublin ",339950,349950,-10000,-2.86,189,Dublin,Leinster
2658,2022-06-28," 68 Radharc an Mhuilinn, Rathwire, Killucan, Westmeath ",260000,235000,25000,10.64,189,Westmeath,Leinster
2661,2022-06-28," 12 The Cairns, Crossakiel, Kells, Co. Meath ",215000,230000,-15000,-6.52,189,Meath,Leinster
2662,2022-06-28," No. 12 Clashrea Place,, Waterford City, Waterford ",125000,135000,-10000,-7.41,189,Waterford,Munster
2666,2022-06-28," Mylerstown, Nurney, Kildare ",445000,450000,-5000,-1.11,190,Kildare,Leinster
2667,2022-06-28," 8 AVONDALE AVENUE, Phibsboro, Dublin 7 ",300000,325000,-25000,-7.69,190,Dublin 7,Leinster
2668,2022-06-28," 21 Rahoon Road, Shantalla, Galway City ",355000,395000,-40000,-10.13,190,Galway,Connaught
2669,2022-06-28," 33 The Courtyard, Dunshaughlin, Meath ",250000,240000,10000,4.17,190,Meath,Leinster
2671,2022-06-28," 8 The Paddocks, Langford Street, Killorglin, Kerry ",265000,285000,-20000,-7.02,190,Kerry,Munster
2672,2022-06-28," 6 Riverwood, Richmond Road, Drumcondra, Dublin 3 ",295000,325000,-30000,-9.23,190,Dublin 3,Leinster
2673,2022-06-28," Crickstown, Curragha , Ashbourne, Meath ",295000,325000,-30000,-9.23,190,Meath,Leinster
2674,2022-06-28," Mooneystown,Athboy,Co. Meath,C15 XY97 ",150000,175000,-25000,-14.29,190,Meath,Leinster
2675,2022-06-28," Blackberry Lodge, Fearragha, Belclare, Co. Galway ",495000,550000,-55000,-10.0,190,Galway,Connaught
2676,2022-06-27," Rockforest, Knock, Roscrea, Co. Tipperary ",160000,200000,-40000,-20.0,190,Tipperary,Munster
2677,2022-06-27," Site At Crowe Abbey, Lower Kindlestown, Greystones, Co. Wicklow ",274000,300000,-26000,-8.67,190,Wicklow,Leinster
2678,2022-06-27," 260 Castletown, Leixlip, Co. Kildare ",450000,500000,-50000,-10.0,190,Kildare,Leinster
2680,2022-06-27," 81 Woodford, Stillorgan, Co. Dublin ",745000,795000,-50000,-6.29,190,Dublin,Leinster
2681,2022-06-27," 24 Saint Nicholas Village, Golf Links Road, Bettystown, Meath ",625000,680000,-55000,-8.09,190,Meath,Leinster
2682,2022-06-27," 35 Millmount Grove, Dundrum, Dublin 14 ",299000,315000,-16000,-5.08,191,Dublin 14,Leinster
2684,2022-06-27," 42 Cluain na Greine, Dungarvan, Waterford ",179000,199000,-20000,-10.05,191,Waterford,Munster
2685,2022-06-27," 14 Cluain Shee, Aikens Village, Sandyford, Dublin 18 ",295000,325000,-30000,-9.23,191,Dublin 18,Leinster
2688,2022-06-27," Brewsterfield, Killarney, Kerry ",250000,220000,30000,13.64,191,Kerry,Munster
2689,2022-06-27," Castlewhite, Waterfall, Cork ",328000,365000,-37000,-10.14,191,Cork,Munster
2690,2022-06-27," The White House, Main Street, Castletownsend, Cork ",650000,720000,-70000,-9.72,191,Cork,Munster
2691,2022-06-27," Shangrila, Williamstown Road, , Waterford City, Waterford ",495000,450000,45000,10.0,191,Waterford,Munster
2692,2022-06-27," 160 Edgewood Lawns, Blanchardstown, Dublin 15 ",279500,290000,-10500,-3.62,191,Dublin 15,Leinster
2695,2022-06-26," 34 Llewellyn Grove, Rathfarnham, Dublin 16 ",495000,485000,10000,2.06,192,Dublin 16,Leinster
2696,2022-06-26," 28 Holywell Crescent, Donaghmede,   Dublin 13 ",390000,420000,-30000,-7.14,192,Dublin 13,Leinster
2697,2022-06-25," Solas,Liccaun,Killea,Dunmore East,Co. Waterford ",320000,360000,-40000,-11.11,192,Waterford,Munster
2698,2022-06-24," Tower Hill,Piltown,Co. Kilkenny,E32EH10 ",285000,300000,-15000,-5.0,192,Kilkenny,Leinster
2699,2022-06-24," 65 Ard Mhuire,Carrick On Suir,Co. Tipperary,E32 YK54 ",135000,120000,15000,12.5,192,Tipperary,Munster
2700,2022-06-24," Kingstown,Clifden,Co.Galway,H71P623 ",575000,695000,-120000,-17.27,192,Galway,Connaught
2701,2022-06-24," 2 Meadow Way, Clonsilla, Dublin 15 ",299950,319950,-20000,-6.25,192,Dublin 15,Leinster
2702,2022-06-24," No 4 Baile Thiobóid, Craanford, Wexford ",345000,375000,-30000,-8.0,192,Wexford,Leinster
2703,2022-06-24," Ballybeg, Ferns, Wexford ",399000,425000,-26000,-6.12,192,Wexford,Leinster
2704,2022-06-24," 13 Peyton Avenue, Rathcoole, County Dublin ",525000,495000,30000,6.06,192,Dublin,Leinster
2705,2022-06-24," Shangrila, Williamstown Road, Waterford City, Waterford ",495000,450000,45000,10.0,193,Waterford,Munster
2706,2022-06-24," 4, Bride Place, Wexford Town, Wexford ",175000,155000,20000,12.9,193,Wexford,Leinster
2707,2022-06-24," Knockatee West, Dunmore, Galway ",265000,275000,-10000,-3.64,193,Galway,Connaught
2710,2022-06-24," 29 Shamrock Grove, Dunleer, Louth ",219999,235000,-15001,-6.38,193,Louth,Leinster
2712,2022-06-24," 23 Carlinn Court, Mullaharlin Road, Dundalk, Co. Louth ",280000,270000,10000,3.7,193,Louth,Leinster
2713,2022-06-24," 53 Leinster Park, Harold's Cross, Dublin 6W ",695000,740000,-45000,-6.08,193,Dublin,Leinster
2716,2022-06-24," 17 Laverna Dale,, Castleknock, Dublin 15 ",520000,550000,-30000,-5.45,193,Dublin 15,Leinster
2717,2022-06-24," 24 Park Ridge Grangerath , Drogheda, Meath ",175000,185000,-10000,-5.41,193,Meath,Leinster
2718,2022-06-24," 72 Jolly Marnier , Athlone East, Westmeath ",240000,250000,-10000,-4.0,193,Westmeath,Leinster
2719,2022-06-24," Cnoc Bui - House On 9.04 Acres,Beldaragh,Ring Commons,Naul,Co Dublin ",945000,975000,-30000,-3.08,194,Dublin,Leinster
2720,2022-06-23," 18 Ballagh Cove,The Ballagh,Co. Wexford,Y21 YH31 ",259000,275000,-16000,-5.82,194,Wexford,Leinster
2721,2022-06-23," Johnstown,Ballyhaunis,Co,Mayo. ",155000,230000,-75000,-32.61,194,Mayo,Connaught
2722,2022-06-23," Johnstown,Ballyhaunis,Co. Mayo,F35TD29 ",210000,250000,-40000,-16.0,194,Mayo,Connaught
2724,2022-06-23," 121 Abbyfield, Ballitore, Kilcullen, Kildare ",230000,220000,10000,4.55,194,Kildare,Leinster
2725,2022-06-23," 121 Abbyfield, Ballitore, Kildare ",230000,220000,10000,4.55,194,Kildare,Leinster
2726,2022-06-23," 121 Abbyfield, Ballitore, Athy, Kildare ",230000,220000,10000,4.55,194,Kildare,Leinster
2728,2022-06-23," Bracken House, Cosher, Kilmuckridge, Wexford ",525000,550000,-25000,-4.55,194,Wexford,Leinster
2729,2022-06-23," Ballybeg Upper, Ferns, Wexford ",370000,385000,-15000,-3.9,195,Wexford,Leinster
2731,2022-06-23," The Pink House, Spiddal West, Spiddal, Co. Galway ",335000,350000,-15000,-4.29,195,Galway,Connaught
2732,2022-06-23," Tillys, Townshend Street, Skibbereen,   West Cork ",195000,220000,-25000,-11.36,195,Cork,Munster
2734,2022-06-23," Newtownbulter Road, Clones, Monaghan ",55000,70000,-15000,-21.43,195,Monaghan,Ulster
2735,2022-06-23," 3 Cill Dara Grove, Drimoleague,   West Cork ",199000,225000,-26000,-11.56,195,Cork,Munster
2736,2022-06-23," 4 Liffey Street South, Inchicore, Dublin 8 ",360000,295000,65000,22.03,195,Dublin 8,Leinster
2737,2022-06-23," 19 Curragh Glen, Upper Aghada, Midleton, Cork ",240000,260000,-20000,-7.69,195,Cork,Munster
2738,2022-06-23," 56 The Meadows, Bullock Park, Carlow Town, Carlow ",350000,340000,10000,2.94,195,Carlow,Leinster
2739,2022-06-23," 10 Larkhill Road, Whitehall,   Dublin 9 ",349950,395000,-45050,-11.41,195,Dublin 9,Leinster
2741,2022-06-23," Marlfield Cottage,Marlbog Road,Haggardstown,Dundalk,Co. Louth ",400000,385000,15000,3.9,196,Louth,Leinster
2744,2022-06-22," 131 Hazelmere, Naas, Kildare ",250000,260000,-10000,-3.85,196,Kildare,Leinster
2745,2022-06-22," 7 Cammock, Kilmainham, Dublin 8 ",325000,250000,75000,30.0,196,Dublin 8,Leinster
2746,2022-06-22," Castlemagarrett,Claremorris,Co Mayo,F12 R585 ",650000,900000,-250000,-27.78,196,Mayo,Connaught
2747,2022-06-22," Derryfadda,Kealkill,Co Cork,P75 F102 ",195000,225000,-30000,-13.33,196,Cork,Munster
2748,2022-06-22," Carrabaun, Westport, Mayo ",550000,675000,-125000,-18.52,196,Mayo,Connaught
2749,2022-06-22," 5 Millbrook Terrace, Kilmainham, Dublin 8 ",260000,275000,-15000,-5.45,196,Dublin 8,Leinster
2750,2022-06-22," 15 Clonuske Drive, Balbriggan, County Dublin ",270000,280000,-10000,-3.57,196,Dublin,Leinster
2751,2022-06-22," 3 Ballydaheen West, Mallow, Cork ",219000,220000,-1000,-0.45,196,Cork,Munster
2752,2022-06-22," 3 Suffolk St, Kells, Co. Meath ",118000,125000,-7000,-5.6,197,Meath,Leinster
2753,2022-06-22," 12 The Lawns, Athlumney Abbey, Navan, Co. Meath ",420000,445000,-25000,-5.62,197,Meath,Leinster
2754,2022-06-22," 4 Kanes Pass, Cooleragh, Coill Dubh, Kildare ",259950,279950,-20000,-7.14,197,Kildare,Leinster
2755,2022-06-22," Avenue House, Boreenmanna Road, Ballinlough,   Cork City ",650000,750000,-100000,-13.33,197,Cork,Munster
2756,2022-06-22," The Gaels' Rest, Clonattin Road, Gorey, Wexford ",340000,420000,-80000,-19.05,197,Wexford,Leinster
2757,2022-06-22," 13 Millbank, Shillelagh, Wicklow ",160000,150000,10000,6.67,197,Wicklow,Leinster
2758,2022-06-22," 6 Bernadette Avenue, Glenbrien, Oilgate, Co. Wexford ",185000,195000,-10000,-5.13,197,Wexford,Leinster
2759,2022-06-22," 1 Crofton Avenue, Dun Laoghaire, Co. Dublin ",1575000,1700000,-125000,-7.35,197,Dublin,Leinster
2760,2022-06-22," 4 Hillcrest, Kingscourt, Cavan ",215000,230000,-15000,-6.52,197,Cavan,Ulster
2761,2022-06-22," 4 Synnott place, North City Centre, Dublin 7 ",640000,700000,-60000,-8.57,197,Dublin 7,Leinster
2762,2022-06-22," 4 Synnott Place, North City Centre, Dublin 7 ",640000,700000,-60000,-8.57,197,Dublin 7,Leinster
2763,2022-06-22," Elton , Knocklong, Limerick ",180000,169000,11000,6.51,197,Limerick,Munster
2764,2022-06-22," Apartment 28 The Oaks Pelletstown Manor, Ashtown, Dublin 15 ",350000,355000,-5000,-1.41,197,Dublin 15,Leinster
2765,2022-06-22," 51 Bracken Hill, Sandyford,   Dublin 18 ",325000,310000,15000,4.84,197,Dublin 18,Leinster
2767,2022-06-22," Stag Cottage, Laragh East, Glendalough, Co. Wicklow ",525000,545000,-20000,-3.67,198,Wicklow,Leinster
2768,2022-06-22,"  9 Bargy Road, East Wall, Dublin 3 ",420000,430000,-10000,-2.33,198,Dublin 3,Leinster
2769,2022-06-22," 24 The Avenue Highlands., Drogheda, Meath ",310000,295000,15000,5.08,198,Meath,Leinster
2770,2022-06-22," Apartment 62, Hampton Wood Road, Finglas, Dublin 11, Finglas, Dublin 11 ",170000,175000,-5000,-2.86,198,Dublin 11,Leinster
2771,2022-06-22," Garryvarren, Ballymurn, Wexford ",495000,530000,-35000,-6.6,198,Wexford,Leinster
2772,2022-06-22," Apt. 9 Wilford Court, Bray, Bray, Wicklow ",365000,375000,-10000,-2.67,198,Wicklow,Leinster
2773,2022-06-22," Greenhall Castlecor, Mallow, Cork ",130000,125000,5000,4.0,198,Cork,Munster
2774,2022-06-22," 24 Malin Hall, Waterville Terrace, Blanchardstown, Dublin 15 ",249950,254950,-5000,-1.96,198,Dublin 15,Leinster
2776,2022-06-21," Friarstown, Bennekerry, Co. Carlow ",349500,370000,-20500,-5.54,198,Carlow,Leinster
2778,2022-06-21," 17 Creagan, Barna, Co. Galway ",329000,348000,-19000,-5.46,198,Galway,Connaught
2779,2022-06-21," 14 Castle St,Cahir,Co Tipperary,E21F344 ",295000,325000,-30000,-9.23,198,Tipperary,Munster
2781,2022-06-21," 131 De Selby Park, Citywest, Dublin 24 ",375000,369000,6000,1.63,199,Dublin 24,Leinster
2782,2022-06-21," 59 Glenmalure Square, Milltown, Dublin 6 ",495000,520000,-25000,-4.81,199,Dublin 6,Leinster
2783,2022-06-21," 81 Ballymun Road Glasnevin Dublin 9, Glasnevin, Dublin 9 ",715000,654750,60250,9.2,199,Dublin 9,Leinster
2785,2022-06-21," Apartment 6, Crosley House, Dock Road, City Centre (Limerick), Limerick City ",130000,140000,-10000,-7.14,199,Limerick,Munster
2786,2022-06-21," 2 St Peter & Paul's Terrace, Bruff, Limerick ",165000,179000,-14000,-7.82,199,Limerick,Munster
2788,2022-06-21," 8 St. Audoen's Terrace, Christchurch, Dublin 8 ",295000,320000,-25000,-7.81,199,Dublin 8,Leinster
2789,2022-06-21," Knockullard, Borris, Carlow ",785000,795000,-10000,-1.26,199,Carlow,Leinster
2791,2022-06-21," 17  Deanery Banks, Bawnboy, Cavan ",239000,259000,-20000,-7.72,199,Cavan,Ulster
2792,2022-06-21," 1 Florence Terrace, Bray, Co. Wicklow, Bray, Wicklow ",1850000,1950000,-100000,-5.13,199,Wicklow,Leinster
2793,2022-06-21," Crook Lane, Mornington, Meath, A92N4X2 ",360000,385000,-25000,-6.49,199,Meath,Leinster
2794,2022-06-21," Oysterbed Road, Sneem, Kerry ",80000,100000,-20000,-20.0,199,Kerry,Munster
2795,2022-06-21," 11 Belfry Close, Citywest, Dublin 24 ",295000,275000,20000,7.27,199,Dublin 24,Leinster
2796,2022-06-21," 22 Gerald Griffin Street, Blackpool, Cork ",400000,450000,-50000,-11.11,199,Cork,Munster
2797,2022-06-21," Rehins, Ballina, Mayo ",465000,545000,-80000,-14.68,200,Mayo,Connaught
2798,2022-06-21," Trim Road,Kiltale,Dunsany,Co. Meath,C15VK26 ",435000,450000,-15000,-3.33,200,Meath,Leinster
2799,2022-06-21," Ballywilliam,Kilcormac,Co Offaly,R42NY06 ",300000,320000,-20000,-6.25,200,Offaly,Leinster
2800,2022-06-20," 3 New Road, Birr, Co. Offaly ",169000,160000,9000,5.63,200,Offaly,Leinster
2802,2022-06-20," Newtown Cottage, Cloughjordan, Newtown, Co. Tipperary ",155000,175000,-20000,-11.43,200,Tipperary,Munster
2803,2022-06-20," Keepers Cove, Palmer Road, Rush, County Dublin ",365000,355000,10000,2.82,200,Dublin,Leinster
2804,2022-06-20," 68 Beechdale Court, Ballycullen,   Dublin 24 ",290000,300000,-10000,-3.33,200,Dublin 24,Leinster
2805,2022-06-20," No. 13 Dinglei coush, Bundoran, Donegal ",280000,300000,-20000,-6.67,200,Donegal,Ulster
2806,2022-06-20," White Strand Cottage, Rusheenduff, Renvyle, Galway ",425000,450000,-25000,-5.56,200,Galway,Connaught
2808,2022-06-20," 18 Tyrconnell Park, Inchicore, Dublin 8 ",400000,350000,50000,14.29,200,Dublin 8,Leinster
2811,2022-06-20," Meadowbank, Rathdermot, Bansha, Tipperary ",290000,295000,-5000,-1.69,201,Tipperary,Munster
2812,2022-06-20," 30C Melvin Fields, Kinlough, Leitrim ",170000,180000,-10000,-5.56,201,Leitrim,Connaught
2813,2022-06-20," 17 Oakland Grove, Scotshouse, Monaghan ",150000,140000,10000,7.14,201,Monaghan,Ulster
2814,2022-06-20," 9 Elm Park, Nutley Lane, Donnybrook, Dublin 4 ",1550000,1700000,-150000,-8.82,201,Dublin 4,Leinster
2816,2022-06-20," 105 Castlebyrne Park, Blackrock, Dublin ",499000,520000,-21000,-4.04,201,Dublin,Leinster
2817,2022-06-20," 103 Sandhills, Hacketstown Rd, Carlow Town, Carlow ",239000,235000,4000,1.7,201,Carlow,Leinster
2818,2022-06-20," 5 Patrick Street, Tramore, Waterford ",240000,250000,-10000,-4.0,201,Waterford,Munster
2819,2022-06-20," Crofton Park, Ballina, Mayo ",90000,70000,20000,28.57,201,Mayo,Connaught
2820,2022-06-19," 2 Cloughandine, County Clare, Liscannor, Co. Clare ",440000,400000,40000,10.0,201,Clare,Munster
2821,2022-06-19," Crosstown House,Ballycogley,Co Wexford,Y35 FF25 ",349000,399000,-50000,-12.53,201,Wexford,Leinster
2822,2022-06-18," 41 Upper St josephs Terrace, Athy, Kildare ",135000,145000,-10000,-6.9,201,Kildare,Leinster
2823,2022-06-18," 81 Roseland Avenue, Cualanor Dun, Dun Laoghaire, Dublin ",1050000,1150000,-100000,-8.7,201,Dublin,Leinster
2824,2022-06-18," Clareen,Birr,Co Offaly,R42 TH93 ",385000,395000,-10000,-2.53,201,Offaly,Leinster
2825,2022-06-18," Moher,Lanesborough,Co. Roscommon,N39 RK35 ",295000,350000,-55000,-15.71,201,Roscommon,Connaught
2826,2022-06-18," Apt.8 Delvin Court,Stamullen,Co Meath,K32 DT28 ",235000,225000,10000,4.44,202,Meath,Leinster
2827,2022-06-17," 10 Steeple Manor,Trim,Co Meath,C15 K526 ",450000,470000,-20000,-4.26,202,Meath,Leinster
2828,2022-06-17," Site At Sandy Lane,Rush,Co Dublin,K56 ",225000,275000,-50000,-18.18,202,Dublin,Leinster
2829,2022-06-17," Wish Willow,Whitepark,Arklow,Co. Wicklow,Y14 WY98 ",1950000,2300000,-350000,-15.22,202,Wicklow,Leinster
2830,2022-06-17," 148 Limekiln Wood,Dublin Road,Navan,Co. Meath,C15 VFH4 ",300000,270000,30000,11.11,202,Meath,Leinster
2832,2022-06-17," Racecourse Road, Roscommon Town ",450000,350000,100000,28.57,202,Roscommon,Connaught
2833,2022-06-17," 31 The Drumlins, Virginia, Cavan ",250000,260000,-10000,-3.85,202,Cavan,Ulster
2834,2022-06-17," Farnascullogue, Ballina, Mayo ",140000,130000,10000,7.69,202,Mayo,Connaught
2835,2022-06-17," 23 Dun Esker, Ballinasloe, Galway ",229500,225000,4500,2.0,202,Galway,Connaught
2837,2022-06-17," 24 Sliabh Carron, Gort, Galway ",215000,195000,20000,10.26,202,Galway,Connaught
2838,2022-06-17," Hoardstown,Lobinstown,Navan,Co Meath,C15 H1F7 ",495000,550000,-55000,-10.0,203,Meath,Leinster
2840,2022-06-17," 116 Clochran, Kilcloghans, Tuam, Galway ",225000,150000,75000,50.0,203,Galway,Connaught
2841,2022-06-17," ""Lissadell House"", Curragha Road, Ratoath, Meath ",975000,575000,400000,69.57,203,Meath,Leinster
2842,2022-06-17," Bishop Street, Tuam, Galway ",170000,180000,-10000,-5.56,203,Galway,Connaught
2844,2022-06-17," 1 Clarinda Park House, Clarinda Park West, Dun Laoghaire, Co. Dublin ",350000,385000,-35000,-9.09,203,Dublin,Leinster
2845,2022-06-17," 2 Botairin Na Muillinn, Dungarvan, Waterford ",170000,195000,-25000,-12.82,203,Waterford,Munster
2848,2022-06-17," 52 Standhouse Lawns, Newbridge, Kildare ",270000,285000,-15000,-5.26,203,Kildare,Leinster
2852,2022-06-17," 4 St Joseph's Terrace, Ballyhooly Road, St Lukes, Cork City ",255000,265000,-10000,-3.77,203,Cork,Munster
2853,2022-06-17," 19 The Old Mill, Ratoath, Meath ",565000,575000,-10000,-1.74,204,Meath,Leinster
2854,2022-06-17," Carrowwilkin, Curry, Sligo ",185000,135000,50000,37.04,204,Sligo,Connaught
2856,2022-06-17," Honeycomb and Honeypot House,Derryduff More,Coomhola,Bantry,Co. Cork ",495000,530000,-35000,-6.6,204,Cork,Munster
2857,2022-06-17," Darraghmore,Kilfinane,Co Limerick,V35 F635 ",275000,295000,-20000,-6.78,204,Limerick,Munster
2859,2022-06-16," The Coach Inn,Waddingtown,Cleariestown,Co. Wexford,Y35 A448 ",295000,280000,15000,5.36,204,Wexford,Leinster
2860,2022-06-16," 9 Rathsallagh Ave, Shankill, Dublin 18 ",449950,475000,-25050,-5.27,204,Dublin 18,Leinster
2865,2022-06-16," 14 Silver Springs, Dungarvan, Waterford ",385000,375000,10000,2.67,204,Waterford,Munster
2869,2022-06-16," Middletown Valley, Ballinatray Upper, Ardamine, Wexford ",50000,49000,1000,2.04,205,Wexford,Leinster
2870,2022-06-16," "" The Sycamore ""Harristown Drive, Kildangan, Kildare ",370000,360000,10000,2.78,205,Kildare,Leinster
2871,2022-06-16," 15 Oakton Green, Ballybrack, Dublin ",520000,499000,21000,4.21,205,Dublin,Leinster
2872,2022-06-16," 34 Charlesland Crescent, Greystones, Wicklow ",335000,340000,-5000,-1.47,205,Wicklow,Leinster
2874,2022-06-16," 22 Doonamana Road, Cabinteely, Dublin 18 ",675000,725000,-50000,-6.9,205,Dublin 18,Leinster
2875,2022-06-16," 54 Holywell, Upper Kilmacud Road, Stillorgan, Co. Dublin ",695000,745000,-50000,-6.71,205,Dublin,Leinster
2876,2022-06-16," 117 Howth Road, Clontarf, Dublin 3 ",450000,485000,-35000,-7.22,205,Dublin 3,Leinster
2877,2022-06-16," 8A,Elm Grove Park, Old Youghal Road, City Centre Nth, Cork ",375000,330000,45000,13.64,206,Cork,Munster
2878,2022-06-16," Apartment 44, Croke Gardens, Thurles, Tipperary ",85000,90000,-5000,-5.56,206,Tipperary,Munster
2879,2022-06-16," Ballyregan House,Killinick,Co Wexford,Y35NF72 ",575000,695000,-120000,-17.27,206,Wexford,Leinster
2880,2022-06-16," 50 Stonyford,Ballivor,Co Meath,C15 C2D9 ",235000,210000,25000,11.9,206,Meath,Leinster
2881,2022-06-15," The Purple Heather,Henry Street,Kenmare,Co. Kerry,V93 ET61 ",690000,800000,-110000,-13.75,206,Kerry,Munster
2883,2022-06-15," 59 Granville Road, Blackrock, County Dublin ",1115000,1195000,-80000,-6.69,206,Dublin,Leinster
2884,2022-06-15," Site With Full Planning Permission,Templebryan South,Shannonvale,Clonakilty,Co Cork ",130000,120000,10000,8.33,206,Cork,Munster
2885,2022-06-15," 80 Greenwood Park, Edenderry, Offaly ",160000,170000,-10000,-5.88,206,Offaly,Leinster
2886,2022-06-15," Island View, Garranagoleen, Clonakilty, Cork ",865000,965000,-100000,-10.36,206,Cork,Munster
2887,2022-06-15," 32 Marybrorough Crescent, Portlaoise, Laois ",165000,139000,26000,18.71,207,Laois,Leinster
2888,2022-06-15," Kilmore, Athleague, Co. Roscommon ",165000,135000,30000,22.22,207,Roscommon,Connaught
2889,2022-06-15," 7 Chapel Lane, Bruff, Co. Limerick ",159000,165000,-6000,-3.64,207,Limerick,Munster
2891,2022-06-15," 17 Lyons Avenue , Newcastle, Dublin ",285000,265000,20000,7.55,207,Dublin,Leinster
2892,2022-06-15," Oldgrange, Monasterevin, Kildare ",400000,425000,-25000,-5.88,207,Kildare,Leinster
2893,2022-06-15," 16 Monaloe Court, Cabinteely, Dublin 18 ",475000,495000,-20000,-4.04,207,Dublin 18,Leinster
2895,2022-06-15," Apartment 148, Block B, The Timber Mill, Kilmore Road, Artane, Dublin 5 ",285000,275000,10000,3.64,207,Dublin 5,Leinster
2896,2022-06-15," The Bungalow, Glenealy, Wicklow ",285000,275000,10000,3.64,207,Wicklow,Leinster
2898,2022-06-15," 11 Newcastle Manor Crescent , Newcastle, Dublin ",365000,355000,10000,2.82,208,Dublin,Leinster
2899,2022-06-15," 18 St. Etchens Court, Kinnegad, Westmeath ",235000,200000,35000,17.5,208,Westmeath,Leinster
2900,2022-06-15," Caplevane, Lusmagh, Co. Offaly ",125000,140000,-15000,-10.71,208,Offaly,Leinster
2901,2022-06-15," Arran Street East, Smithfield, Dublin 7 ",460000,430000,30000,6.98,208,Dublin 7,Leinster
2903,2022-06-15," 83 The Belfry,Trim,Co Meath,C15 P2E1 ",315000,320000,-5000,-1.56,208,Meath,Leinster
2904,2022-06-15," 18 Kellys Bay Heights,Skerries,Co. Dublin,K34 YA71 ",269000,285000,-16000,-5.61,208,Dublin,Leinster
2905,2022-06-15," Acorn Lodge,Boherash,Mallow,Co. Cork,P51 TW44 ",230000,235000,-5000,-2.13,208,Cork,Munster
2906,2022-06-15," Liseux,Hillview,Old Road,Cashel,Co Tipperary ",230000,250000,-20000,-8.0,208,Tipperary,Munster
2907,2022-06-14," 58 Jolly Mariner Marina Village, Athlone, Co. Westmeath ",249000,259000,-10000,-3.86,208,Westmeath,Leinster
2910,2022-06-14," Renvyle, Falls Road, Rathmichael, Dublin 18 ",2750000,2950000,-200000,-6.78,208,Dublin 18,Leinster
2911,2022-06-14," 17 Village Court, Upper Patrick Street, Co. Kilkenny ",270000,290000,-20000,-6.9,208,Kilkenny,Leinster
2912,2022-06-14," Kilrush Creek Marina, Merchants Quay, Kilrush, Clare ",200000,250000,-50000,-20.0,208,Clare,Munster
2913,2022-06-14," 39 Moore Park, Newbridge, Kildare ",430000,410000,20000,4.88,209,Kildare,Leinster
2914,2022-06-14," Coorycommane, Coomhola Bridge, Bantry, Co. Cork ",295000,325000,-30000,-9.23,209,Cork,Munster
2916,2022-06-14," 28 Roseland Avenue, Cualanor Crescent, Dun Laoghaire, Co. Dublin ",995000,1075000,-80000,-7.44,209,Dublin,Leinster
2917,2022-06-14," 12 Hillview, Summerhill, Meath ",440000,430000,10000,2.33,209,Meath,Leinster
2918,2022-06-14," Paris, Heir Island, Islands,   West Cork ",695000,775000,-80000,-10.32,209,Cork,Munster
2919,2022-06-14," Main Street , Clifden, Galway ",625000,675000,-50000,-7.41,209,Galway,Connaught
2920,2022-06-14," Ardeevin, Church Hill, Wicklow Town, Wicklow ",595000,650000,-55000,-8.46,209,Wicklow,Leinster
2921,2022-06-14," Site at 1 St. Bridget's Place, Church Bay, Crosshaven, Cork ",140000,160000,-20000,-12.5,209,Cork,Munster
2922,2022-06-14," 13 Roselawn Rosehill , Kilkenny, Kilkenny ",350000,365000,-15000,-4.11,209,Kilkenny,Leinster
2923,2022-06-14," The Yews,Rocky Road,County Wicklow,A67 WP60 ",395000,495000,-100000,-20.2,210,Wicklow,Leinster
2924,2022-06-14," Ardnurcher Glebe,Horseleap,Co Westmeath,N37PX21 ",699000,770000,-71000,-9.22,210,Westmeath,Leinster
2925,2022-06-13," 12 main street, ongar village, dublin 15, Dublin 15, Dublin ",280000,255000,25000,9.8,210,Dublin 15,Leinster
2926,2022-06-13," Apartment 1, The Green Building, 23, 24 Temple Lane South, Dublin 2, Dublin ",365000,360000,5000,1.39,210,Dublin,Leinster
2927,2022-06-13," Kilbaha,Kilrush,Co. Clare,V15 FC44 ",199000,220000,-21000,-9.55,210,Clare,Munster
2928,2022-06-13," 9 Church Avenue, Glasnevin, Dublin 9 ",285000,250000,35000,14.0,210,Dublin 9,Leinster
2929,2022-06-13," Church Hill, Passage West, Cork ",259000,275000,-16000,-5.82,210,Cork,Munster
2930,2022-06-13," 36 Riverwalk, Collooney, Sligo ",179000,185000,-6000,-3.24,210,Sligo,Connaught
2931,2022-06-13," Apt. 57 CHAPELGATE, Block B, ST. ALPHONSUS' ROAD UPPER, Drumcondra, Dublin 9 ",375000,350000,25000,7.14,210,Dublin 9,Leinster
2932,2022-06-13," 14 Millbrook, Milltown, Galway ",129000,145000,-16000,-11.03,211,Galway,Connaught
2933,2022-06-13," 31 Eugene Street, South City Centre - D8, Dublin 8 ",220000,240000,-20000,-8.33,211,Dublin 8,Leinster
2935,2022-06-13," 33 Wycherley Place, College Road, Glasheen, Cork City ",255000,260000,-5000,-1.92,211,Cork,Munster
2936,2022-06-13," 151 Gleann Na Ri, Cabinteely, Dublin 18 ",305000,325000,-20000,-6.15,211,Dublin 18,Leinster
2937,2022-06-13," 14 The Village, Enniskerry Road, Stepaside, Dublin 18 ",350000,315000,35000,11.11,211,Dublin 18,Leinster
2938,2022-06-13," 26 Malachi Road, Stoneybatter Stoneybatter, North Dublin City, Stoneybatter, Dublin 7 ",275000,250000,25000,10.0,211,Dublin 7,Leinster
2941,2022-06-10," 4 Glandore Park, Lower Mounttown Road, Dun Laoghaire, Co. Dublin ",775000,895000,-120000,-13.41,211,Dublin,Leinster
2942,2022-06-10," 45 Trimleston , Balbriggan, Dublin ",325000,335000,-10000,-2.99,211,Dublin,Leinster
2943,2022-06-10," Glannamara, 41 Coliemore Road, Dalkey, Co. Dublin ",2695000,2950000,-255000,-8.64,211,Dublin,Leinster
2945,2022-06-10," Cliff Court, Rock Road East, Blackrock, Dundalk, Co. Louth ",750000,849000,-99000,-11.66,212,Louth,Leinster
2947,2022-06-10," Dun Beara, Drummond, Longwood, Meath ",980000,950000,30000,3.16,212,Meath,Leinster
2948,2022-06-10," 13 The Square, Innwood, Enfield, Co. Meath ",185000,175000,10000,5.71,212,Meath,Leinster
2949,2022-06-10," Eslinbridge , Mohill, Leitrim ",125000,110000,15000,13.64,212,Leitrim,Connaught
2950,2022-06-10," 8 Hollybrook, Robinstown, Navan, Meath ",485000,470000,15000,3.19,212,Meath,Leinster
2951,2022-06-10," Main Street, Kilmeague, Naas, Co Kildare, Naas, Kildare ",199000,245000,-46000,-18.78,212,Kildare,Leinster
2954,2022-06-10," Clonea Road, Kilminnin South, Dungarvan, Waterford ",695000,730000,-35000,-4.79,212,Waterford,Munster
2956,2022-06-10," 5 Park Villas, Blackrock, Co. Dublin ",1695000,1850000,-155000,-8.38,213,Dublin,Leinster
2957,2022-06-10," Ref 892 - New Road, Portmagee, Kerry ",175000,170000,5000,2.94,213,Kerry,Munster
2958,2022-06-10," 11 Mill Haven, Castlebridge, Co. Wexford ",168000,185000,-17000,-9.19,213,Wexford,Leinster
2959,2022-06-10," Lambhill, Tuam, Galway ",195000,220000,-25000,-11.36,213,Galway,Connaught
2960,2022-06-10," 94 Ballintyre Square, Ballinteer,   Dublin 16 ",420000,340000,80000,23.53,213,Dublin 16,Leinster
2961,2022-06-09," 48 Monastery Avenue,Taghmon,Co. Wexford,Y35 E225 ",150000,169000,-19000,-11.24,213,Wexford,Leinster
2962,2022-06-09," Mount Carmel, Novara Avenue, Bray, Wicklow ",685000,725000,-40000,-5.52,213,Wicklow,Leinster
2963,2022-06-09," Ummeryroe, Geevagh, Sligo ",99000,120000,-21000,-17.5,213,Sligo,Connaught
2964,2022-06-09," 133 Brandon Square, Waterville, Blanchardstown, Dublin 15 ",545000,525000,20000,3.81,213,Dublin 15,Leinster
2966,2022-06-09," No. 1 Upper Glenview Terrace, Gurteenroe, Macroom, Cork ",175000,160000,15000,9.38,213,Cork,Munster
2967,2022-06-09," 111 Green Court Parnell St. , North City Centre, Dublin 1 ",390000,395000,-5000,-1.27,213,Dublin 1,Leinster
2968,2022-06-09," 38 Cloch Ard, Bothar Stiofain, Knocknacarra, Galway ",385000,380000,5000,1.32,214,Galway,Connaught
2969,2022-06-09," 92 Parchment Square, The Behan Block, Model Farm Road,   Cork City ",185000,190000,-5000,-2.63,214,Cork,Munster
2970,2022-06-09," 173 Applewood Heights, Greystones, Wicklow ",720000,695000,25000,3.6,214,Wicklow,Leinster
2971,2022-06-09," 89 Johnstown Avenue, Dun Laoghaire, Co. Dublin ",650000,700000,-50000,-7.14,214,Dublin,Leinster
2972,2022-06-09," 188 Butterfield Avenue, Rathfarnham, Dublin 14 ",895000,750000,145000,19.33,214,Dublin 14,Leinster
2973,2022-06-09," 26 College Green, Green Road, Carlow Town, Carlow ",220000,195000,25000,12.82,214,Carlow,Leinster
2975,2022-06-09," Apt, 11 Brook House, Corrig Avenue, Dun Laoghaire, Co. Dublin ",695000,745000,-50000,-6.71,214,Dublin,Leinster
2976,2022-06-09," Stradbally East, Kilcolgan, Galway ",250000,290000,-40000,-13.79,214,Galway,Connaught
2977,2022-06-09," 5 Blackthorn Court, Sandyford, Dublin ",475000,485000,-10000,-2.06,214,Dublin,Leinster
2979,2022-06-09," 18 Hazelwood,Bridgetown,Co. Wexford,Y35 HH94 ",119000,199000,-80000,-40.2,215,Wexford,Leinster
2980,2022-06-09," 6 The Grove,Old Course,Mallow,Co. Cork.,P51 FFP5 ",245000,195000,50000,25.64,215,Cork,Munster
2982,2022-06-08," 4 Bruach na hAbhann,Western Road,Clonakilty,Co Cork,P85 NR53 ",269000,295000,-26000,-8.81,215,Cork,Munster
2983,2022-06-08," Comer,Dublin Road,Naas,Co Kildare,W91 YE2X ",530000,497500,32500,6.53,215,Kildare,Leinster
2984,2022-06-08," Bridge Street, Ringsend, Dublin 4 ",495000,535000,-40000,-7.48,215,Dublin 4,Leinster
2985,2022-06-08," 1 Cahir Lodges,Cahir West,Kenmare,Co Kerry,V93 W088 ",695000,650000,45000,6.92,215,Kerry,Munster
2986,2022-06-08," Ardeevin House,Ferns,Enniscorthy,Co Wexford,Y21 Y8P8 ",350000,270000,80000,29.63,215,Wexford,Leinster
2987,2022-06-08," Fleenstown, Ward, Dublin ",525000,575000,-50000,-8.7,215,Dublin,Leinster
2988,2022-06-08," Gan Uimhir Balbriggan Street, Skerries, Co. Dublin ",685000,725000,-40000,-5.52,215,Dublin,Leinster
2989,2022-06-08," 46 Grafton Hall, South City Centre, Dublin 2 ",340000,275000,65000,23.64,215,Dublin 2,Leinster
2991,2022-06-08," 8 An Corran, Oram, Castleblayney, Monaghan ",175000,195000,-20000,-10.26,215,Monaghan,Ulster
2992,2022-06-08," Betaghstown, Clane, Kildare ",160000,170000,-10000,-5.88,215,Kildare,Leinster
2993,2022-06-08," 432 Olcovar, Shankill, Dublin 18 ",350000,375000,-25000,-6.67,215,Dublin 18,Leinster
2994,2022-06-08," 1 Ballybrack, Borris, Co. Carlow ",250000,235000,15000,6.38,216,Carlow,Leinster
2995,2022-06-08," Barrack St, Castlecomer, Kilkenny ",275000,270000,5000,1.85,216,Kilkenny,Leinster
2996,2022-06-08," 35 Heathervue, Greystones, Co. Wicklow ",720000,695000,25000,3.6,216,Wicklow,Leinster
2998,2022-06-08," Rathkip, Ballina, Mayo ",340000,350000,-10000,-2.86,216,Mayo,Connaught
2999,2022-06-08," 2 Orilia Terrace, Cobh, Cork ",242500,260000,-17500,-6.73,216,Cork,Munster
3000,2022-06-08," Rose Cottage, Red Row, Ballintray Lower, Courtown, Wexford ",295000,319000,-24000,-7.52,216,Wexford,Leinster
3001,2022-06-08," 14 The Barley House, The Coombe, Dublin 8 ",450000,345000,105000,30.43,216,Dublin 8,Leinster
3003,2022-06-08," Cloongullan,Swinford,Co. Mayo,F12 RX58 ",599000,630000,-31000,-4.92,216,Mayo,Connaught
3004,2022-06-08," 19 Parnell Court, Harold's Cross - D12, Dublin 12 ",395000,420000,-25000,-5.95,216,Dublin 12,Leinster
3005,2022-06-08," 34 Rosedale, Inchicore, Dublin 8 ",320000,275000,45000,16.36,216,Dublin 8,Leinster
3006,2022-06-08," 22 Avenue Grove,The Avenue,Gorey,Co. Wexford,Y25 RD21 ",179950,190000,-10050,-5.29,216,Wexford,Leinster
3008,2022-06-07," Site,Morrison Terrace,Ballina,Co Mayo ",65000,75000,-10000,-13.33,216,Mayo,Connaught
3010,2022-06-07," Gortnasillagh West, Drumkeeran, Co Leitrim, N41 AY16 ",75000,65000,10000,15.38,217,Leitrim,Connaught
3012,2022-06-07," 1 Geraldine Terrace, Milltown, Dublin 6 ",425000,475000,-50000,-10.53,217,Dublin 6,Leinster
3013,2022-06-07," Glengarriff,Newtownshandrum,Charleville,Co Cork,P56 N726 ",225000,235000,-10000,-4.26,217,Cork,Munster
3016,2022-06-07," No. 103 Whitemaple Drive, Church Road, Bundoran, Donegal ",185000,190000,-5000,-2.63,217,Donegal,Ulster
3017,2022-06-07," 8 Oldtown Rise, Naas, Kildare ",480000,485000,-5000,-1.03,217,Kildare,Leinster
3018,2022-06-07," Old Parochial House, Railway Road, Kilmallock, Limerick ",425000,450000,-25000,-5.56,217,Limerick,Munster
3021,2022-06-07," 21 Grange Park, Douglas, Cork ",285000,300000,-15000,-5.0,217,Cork,Munster
3022,2022-06-07," Ballylynch, Baltimore,   West Cork ",625000,645000,-20000,-3.1,217,Cork,Munster
3024,2022-06-07," Oldcourt, Piltown, Kilkenny ",60000,69000,-9000,-13.04,217,Kilkenny,Leinster
3025,2022-06-07," Derryloughbannow, Lanesboro, Longford ",275000,395000,-120000,-30.38,218,Longford,Leinster
3026,2022-06-07," 48 Innisfallen Pde (4 Self Contained Units), Phibsboro, Dublin 7 ",395000,449950,-54950,-12.21,218,Dublin 7,Leinster
3027,2022-06-05," Drumcree, Giltspur Lane, Southern Cross Road, Bray, Co. Wicklow ",665000,650000,15000,2.31,218,Wicklow,Leinster
3029,2022-06-04," Residence at Carrigacat, Goleen,   West Cork ",495000,550000,-55000,-10.0,218,Cork,Munster
3030,2022-06-03," No 11 Blackrock Drive Ballybofey, Co. Donegal ",260000,249000,11000,4.42,218,Donegal,Ulster
3031,2022-06-03,"  Nidero, 33 Burnaby Park, Greystones, Wicklow ",990000,975000,15000,1.54,218,Wicklow,Leinster
3033,2022-06-03," 4 Clos Na Manach,Quin,Co Clare,V95 E523 ",200000,185000,15000,8.11,218,Clare,Munster
3035,2022-06-03," 151 Tyrconnell Park, Inchicore, Dublin 8 ",390000,325000,65000,20.0,218,Dublin 8,Leinster
3036,2022-06-03," 41-43 Charleville Close, Rathmines,   Dublin 6 ",400000,450000,-50000,-11.11,218,Dublin 6,Leinster
3037,2022-06-03," Prior Park House,05 Redwood Gardens,Prior Park,Clonmel,Co. Tipperary ",400000,335000,65000,19.4,218,Tipperary,Munster
3038,2022-06-03," Cregganna Beg, Oranmore, Co. Galway, Oranmore, Galway ",515000,575000,-60000,-10.43,219,Galway,Connaught
3040,2022-06-03," 3 Ballygeardra, Hugginstown, Kilkenny ",410000,425000,-15000,-3.53,219,Kilkenny,Leinster
3041,2022-06-03," 29 St John's Well Way, Kilmainham, Dublin 8 ",385000,345000,40000,11.59,219,Dublin 8,Leinster
3042,2022-06-03," 45 St. Corban's Place, Naas, Kildare ",235000,250000,-15000,-6.0,219,Kildare,Leinster
3043,2022-06-03," Ballinakill,Garryhill, Fenagh, Carlow ",260000,280000,-20000,-7.14,219,Carlow,Leinster
3044,2022-06-03," No. 9 Brandon Way, Earlscourt, Waterford City, Waterford ",285000,295000,-10000,-3.39,219,Waterford,Munster
3045,2022-06-03," 2 Colliers Way,Portlaoise,Co. Laois,R32 HXT2 ",310000,299000,11000,3.68,219,Laois,Leinster
3046,2022-06-02," Ballindoolin House,Carbury,Co. Kildare,R45 V653 ",4750000,9250000,-4500000,-48.65,219,Kildare,Leinster
3047,2022-06-02," 65 Drogheda Street,Balbriggan,Co. Dublin,K32VP40 ",245000,239500,5500,2.3,219,Dublin,Leinster
3048,2022-06-02," 83 Jamestown Avenue, Inchicore, Dublin 8 ",375000,325000,50000,15.38,219,Dublin 8,Leinster
3049,2022-06-02," Farmhill,Ardramon,Crossabeg,Co Wexford,Y35 W6W0 ",375000,415000,-40000,-9.64,219,Wexford,Leinster
3050,2022-06-02," Woodlane,Kildalkey,Co. Meath ",65000,60000,5000,8.33,219,Meath,Leinster
3051,2022-06-02," Moonroe, Knocktopher, Co. Kilkenny ",128000,140000,-12000,-8.57,219,Kilkenny,Leinster
3052,2022-06-02," 91 Griffin Rath Hall,Maynooth,Co. Kildare,W23 K7R0 ",335000,350000,-15000,-4.29,219,Kildare,Leinster
3053,2022-06-02," 11 Ramleh Hall, Convent Avenue, Mt St Annes, Milltown,   Dublin 6 ",595000,635000,-40000,-6.3,219,Dublin 6,Leinster
3054,2022-06-02," 104 Arthur Griffith Park, Lucan, Co. Dublin ",299000,290000,9000,3.1,219,Dublin,Leinster
3056,2022-06-02," Marine Court, Blackrock, Louth ",375000,350000,25000,7.14,220,Louth,Leinster
3057,2022-06-02," Eglington, Leinster Walk, Kildare Town, Kildare ",280000,300000,-20000,-6.67,220,Kildare,Leinster
3058,2022-06-02," 117 The Meadows, Cornelscourt, Newbridge, Kildare ",325000,310000,15000,4.84,220,Kildare,Leinster
3060,2022-06-02," 1 Ballynakelly Edge, Newcastle, Dublin ",255000,205000,50000,24.39,220,Dublin,Leinster
3061,2022-06-02," Apt1 Coille Bheithe, Nenagh, Tipperary ",129500,139500,-10000,-7.17,220,Tipperary,Munster
3063,2022-06-02," 13 Abbeyfield, Milltown, Dublin 6 ",420000,435000,-15000,-3.45,220,Dublin 6,Leinster
3064,2022-06-02," Ballinkina House, Woodstown, Co. Waterford, Waterford City, Waterford ",479000,495000,-16000,-3.23,220,Waterford,Munster
3065,2022-06-02," Castlerea Road, Ballaghaderreen, Roscommon ",190000,209000,-19000,-9.09,220,Roscommon,Connaught
3066,2022-06-02," 388 The Sycamores, Portarlington, Laois ",165000,180000,-15000,-8.33,220,Laois,Leinster
3067,2022-06-02," Bridewell Street, Tarbert, Kerry ",180000,250000,-70000,-28.0,221,Kerry,Munster
3069,2022-06-02," 6 Ceol Na Mara,Lower Main Street,Rush,Co Dublin,K56 KD71 ",365000,345000,20000,5.8,221,Dublin,Leinster
3070,2022-06-01," 11 Avonbeg Drive,Friars Hill,Wicklow Town,A67 V903 ",495000,525000,-30000,-5.71,221,Wicklow,Leinster
3071,2022-06-01," Suville, 10 Woodville Court , Artane, Dublin 5 ",440000,435000,5000,1.15,221,Dublin 5,Leinster
3072,2022-06-01," 4 Apartments,8 William Street,Waterford,X91 HY98 ",225000,240000,-15000,-6.25,221,Waterford,Munster
3073,2022-06-01," 18 Dún Rí,Bunratty,Co Clare,V95 TYH4 ",495000,525000,-30000,-5.71,221,Clare,Munster
3074,2022-06-01," 6 Kennedy Park,Roscrea,Co Tipperary,E53 YY71 ",130000,135000,-5000,-3.7,221,Tipperary,Munster
3075,2022-06-01," 3 Grove St,Roscrea,Co Tipperary,E53 NT93 ",99000,129000,-30000,-23.26,221,Tipperary,Munster
3077,2022-06-01," 5 St. John's Terrace,Mill Park Road,Enniscorthy,Co. Wexford,Y21 P8W3 ",400000,390000,10000,2.56,221,Wexford,Leinster
3078,2022-06-01," Clonhaston,Enniscorthy,Co. Wexford,Y21 X8H0 ",399500,425000,-25500,-6.0,221,Wexford,Leinster
3079,2022-06-01," 12 St James Court, Kilmainham, Dublin 8 ",335000,285000,50000,17.54,221,Dublin 8,Leinster
3082,2022-06-01," 6 Pinewood, Mallow, Cork ",210000,220000,-10000,-4.55,222,Cork,Munster
3084,2022-06-01," 4 Old Clonmore Road, Mullingar, Co. Westmeath ",129950,139950,-10000,-7.15,222,Westmeath,Leinster
3085,2022-06-01," 10 Douglas House, Douglas, Cork City ",275000,290000,-15000,-5.17,222,Cork,Munster
3086,2022-06-01," 71 Huntstown Wood, Mulhuddart, Dublin 15 ",265000,270000,-5000,-1.85,222,Dublin 15,Leinster
3090,2022-06-01," 29 Myrtle House, Longfield Road, The Coast, Baldoyle, Dublin ",345000,350000,-5000,-1.43,222,Dublin,Leinster
3091,2022-06-01," Apartment 20 Dunloe Hall, South City Centre, Dublin 2 ",425000,465000,-40000,-8.6,222,Dublin 2,Leinster
3093,2022-06-01," 7, Adare Close, Killincarrig Village, Greystones, Wicklow ",580000,565000,15000,2.65,222,Wicklow,Leinster
3094,2022-06-01," 20 Curragh Glen, Upper Aghada, Midleton, Cork ",260000,215000,45000,20.93,222,Cork,Munster
3097,2022-06-01," The Fastnet Bar, Main Street, Goleen,   West Cork ",290000,320000,-30000,-9.38,223,Cork,Munster
3098,2022-06-01," 17 Maple Court,Phelim Wood,Tullow,Co. Carlow,R93 RT02 ",179500,158950,20550,12.93,223,Carlow,Leinster
3099,2022-06-01," 43 Shandra Woods,Portarlington,Co. Laois,R32VY04 ",199000,215000,-16000,-7.44,223,Laois,Leinster
3100,2022-05-31," Bunoscionn,Drimsree,Rathangan,Co Kildare,R51 Y868 ",369500,390000,-20500,-5.26,223,Kildare,Leinster
3101,2022-05-31," 83 Greenfields, Rosbrien, Limerick, Limerick City, Co. Limerick ",220000,195000,25000,12.82,223,Limerick,Munster
3102,2022-05-31," Ballyrafter House On C.14acres,Lismore,Co Waterford,P51 Y362 ",1350000,1150000,200000,17.39,223,Waterford,Munster
3105,2022-05-31," 2 Sally Grove, Ballycullen, Dublin ",435000,390000,45000,11.54,224,Dublin,Leinster
3106,2022-05-31," 118 Monread Heights , Naas, Kildare ",325000,295000,30000,10.17,224,Kildare,Leinster
3107,2022-05-31," Seamount, Courtown, Wexford ",350000,320000,30000,9.38,224,Wexford,Leinster
3108,2022-05-31," Hazel Brooke, Spa Glen, Mallow, Cork ",315000,340000,-25000,-7.35,224,Cork,Munster
3110,2022-05-31," Apartment 201 The Distillery, Drumcondra, Dublin 3 ",325000,345000,-20000,-5.8,224,Dublin 3,Leinster
3111,2022-05-31," 302 An Colm Choille, Bettystown Town Centre, Bettystown, Meath ",159000,169950,-10950,-6.44,224,Meath,Leinster
3112,2022-05-31," 10 Summervile Park Upper Rathmines Road, Rathmines, Dublin 6 ",945000,975000,-30000,-3.08,224,Dublin 6,Leinster
3113,2022-05-31," 10 Ardfallen Road, Douglas, Cork ",385000,380000,5000,1.32,224,Cork,Munster
3115,2022-05-31," 196 Beechwood Court, Stillorgan Road, Blackrock, County Dublin ",410000,420000,-10000,-2.38,224,Dublin,Leinster
3116,2022-05-31," Goulane East, Lispole, Kerry ",250000,285000,-35000,-12.28,224,Kerry,Munster
3117,2022-05-31," 21 Glenheights Park, Ballyvolane, Cork ",225000,235000,-10000,-4.26,224,Cork,Munster
3118,2022-05-30," 105 Canterbrook,Navan,Co. Meath,C15 R7AC ",260000,280000,-20000,-7.14,225,Meath,Leinster
3119,2022-05-30," 61 Charlesland Park , Greystones, Wicklow ",315000,300000,15000,5.0,225,Wicklow,Leinster
3120,2022-05-30," Lismouragha, Errill, Laois ",100000,110000,-10000,-9.09,225,Laois,Leinster
3122,2022-05-30," 13 Cregg Lawns, Carrick-on-Suir, Tipperary ",205000,220000,-15000,-6.82,225,Tipperary,Munster
3123,2022-05-30," 10 The Paddocks, Duffs Farm, Termonfeckin, Louth ",220000,250000,-30000,-12.0,225,Louth,Leinster
3124,2022-05-30," 21 Reilean, Roscam, Galway ",318000,325000,-7000,-2.15,225,Galway,Connaught
3125,2022-05-30," No. 20 Ballytruckle Green, Ballytruckle, Waterford City, Waterford ",152000,140000,12000,8.57,225,Waterford,Munster
3126,2022-05-30," 30 Cruachán, Knockateemore, Dungarvan, Co. Waterford, Dungarvan, Waterford ",240000,265000,-25000,-9.43,225,Waterford,Munster
3127,2022-05-28," 12 Saint Mary's Road, Kingscourt, Cavan ",225000,248500,-23500,-9.46,225,Cavan,Ulster
3128,2022-05-28," 31 Grange Road, New Ross, Wexford ",189500,179500,10000,5.57,225,Wexford,Leinster
3129,2022-05-28," Derryronane,Swinford,Co Mayo,F12KW57 ",215000,195000,20000,10.26,225,Mayo,Connaught
3130,2022-05-28," 14 Kelly's Bay Tide,Skerries,Co Dublin,K34 XD65 ",295000,285000,10000,3.51,225,Dublin,Leinster
3131,2022-05-27," Creevy, Carrickmacross, Co. Monaghan ",429000,419000,10000,2.39,225,Monaghan,Ulster
3132,2022-05-27," Clonmoney West,Bunratty,Co Clare,V95 FK7X ",175000,120000,55000,45.83,225,Clare,Munster
3133,2022-05-27," 79 Park Lane, Grange Rath, Drogheda, Meath ",330000,340000,-10000,-2.94,226,Meath,Leinster
3134,2022-05-27," Aran View,Dunmore,Doonbeg,Co Clare,V15 RF21 ",300000,249000,51000,20.48,226,Clare,Munster
3135,2022-05-27," 31 Highfield Park, Ballincollig, Cork ",325000,315000,10000,3.17,226,Cork,Munster
3136,2022-05-27," Shraheens,Achill Sound,Achill Island,Co. Mayo ",85000,100000,-15000,-15.0,226,Mayo,Connaught
3139,2022-05-27," 8 The Pines, Grove House, Milltown Road, Dublin 6, Dublin ",525000,495000,30000,6.06,226,Dublin 6,Leinster
3140,2022-05-27," Coolgreine, Rushbrooke, Cobh, Cork ",795000,845000,-50000,-5.92,226,Cork,Munster
3141,2022-05-27," 6 Watermint Court, Phelan Avenue, Ashtown, Dublin 15 ",345000,340000,5000,1.47,226,Dublin 15,Leinster
3142,2022-05-27," 18 Rosbercon Court, New Ross, Wexford ",119000,109000,10000,9.17,226,Wexford,Leinster
3145,2022-05-27," 19 The Mews, Lee Road, City Centre Sth, Cork ",150000,190000,-40000,-21.05,226,Cork,Munster
3146,2022-05-27," 1 Riverside Close, Ballinode, Monaghan ",220000,210000,10000,4.76,226,Monaghan,Ulster
3148,2022-05-27," 69 Grattan Lodge, Hole in the Wall Road, Donaghmede, Dublin 13 ",450000,459000,-9000,-1.96,227,Dublin 13,Leinster
3149,2022-05-27," The Village, Cloghane, Kerry ",130000,160000,-30000,-18.75,227,Kerry,Munster
3151,2022-05-27," 11 The Granary, Distillery Lofts, Drumcondra, Dublin 3 ",295000,325000,-30000,-9.23,227,Dublin 3,Leinster
3152,2022-05-27," Oranbay, Oranhill, Oranmore, Co. Galway ",275000,285000,-10000,-3.51,227,Galway,Connaught
3153,2022-05-26," 11 Maple House,Shannon,Co Clare,V14 Y981 ",105000,120000,-15000,-12.5,227,Clare,Munster
3154,2022-05-26," 6 Riverchapel Row,Riverchapel,Co. Wexford,Y25 RY23 ",235000,220000,15000,6.82,227,Wexford,Leinster
3155,2022-05-26," 102 Abbeyville, Galway Road, Roscommon Town ",195000,225000,-30000,-13.33,227,Roscommon,Connaught
3156,2022-05-26," Apartment 1 River House, New Quay, Clonmel, Co. Tipperary ",80000,70000,10000,14.29,227,Tipperary,Munster
3157,2022-05-26," 16 Forestwood Close, Santry Avenue Santry, Santry, Dublin ",325000,350000,-25000,-7.14,227,Dublin,Leinster
3158,2022-05-26," Sites At Man O War,Malheney,Skerries,Co. Dublin,DUBLIN ",160000,170000,-10000,-5.88,227,Dublin,Leinster
3159,2022-05-26," Carrigane,4 Ticknock Close,Briggs Lane,Arklow,Co. Wicklow ",550000,575000,-25000,-4.35,227,Wicklow,Leinster
3162,2022-05-26," 16 Ard Álainn, Fethard, Tipperary ",185000,205000,-20000,-9.76,227,Tipperary,Munster
3163,2022-05-26," 62 Kennington Road, Templeogue, Dublin 6W ",595000,625000,-30000,-4.8,228,Dublin,Leinster
3166,2022-05-26, Drumrora SG Ballyjamesduff Co Cavan ,45000,70000,-25000,-35.71,228,Cavan,Ulster
3168,2022-05-26," Kylebeg, Borris-in-Ossory, Laois ",50000,70000,-20000,-28.57,228,Laois,Leinster
3169,2022-05-26," Manor,Tulsk,Castlerea,Co. Roscommon,F45DX39 ",40000,35000,5000,14.29,228,Roscommon,Connaught
3171,2022-05-25," 4b Chapel Lane,Claremorris,Co Mayo,F12 Y0E3 ",65000,59000,6000,10.17,228,Mayo,Connaught
3172,2022-05-25," 32 Patrick Street,Kilkenny,R95 TCF6 ",695000,650000,45000,6.92,228,Kilkenny,Leinster
3174,2022-05-25," 56 Dexter Terrace, Northbrook Rd, Ranelagh, Dublin 6 ",620000,595000,25000,4.2,228,Dublin 6,Leinster
3178,2022-05-25," 61 Ballycanew Court, Ballycanew, Gorey, Wexford ",240000,225000,15000,6.67,229,Wexford,Leinster
3179,2022-05-25," 3 Parkview Terrace, Bray, Bray, Wicklow ",349000,369000,-20000,-5.42,229,Wicklow,Leinster
3180,2022-05-25," 109 Marlborough Road, Donnybrook, Dublin 4 ",1350000,1400000,-50000,-3.57,229,Dublin 4,Leinster
3181,2022-05-25," 20 Old Burrin, Carlow Town, Carlow ",239000,249000,-10000,-4.02,229,Carlow,Leinster
3182,2022-05-25," Ballydonoghue, Glin, Limerick, V31N244 ",80000,89000,-9000,-10.11,229,Limerick,Munster
3183,2022-05-25," Craffield, Aughrim, Wicklow ",250000,200000,50000,25.0,229,Wicklow,Leinster
3184,2022-05-25," 6 Holly Park, Bay Estate, Dundalk, Co. Louth ",234000,240000,-6000,-2.5,229,Louth,Leinster
3186,2022-05-25," 70 Ashthorn Avenue, Headford, Galway ",280000,265000,15000,5.66,229,Galway,Connaught
3187,2022-05-25," 6, The Crescent, Cobh, Cork ",680000,730000,-50000,-6.85,229,Cork,Munster
3188,2022-05-25," 61A Serpentine Avenue, Sandymount, Dublin 4 ",795000,895000,-100000,-11.17,229,Dublin 4,Leinster
3189,2022-05-25," 87 Rockview, Blackglen Road, Sandyford, Dublin 18 ",305000,310000,-5000,-1.61,230,Dublin 18,Leinster
3191,2022-05-25," 3 St Patricks Park, Stepaside, Dublin 18 ",450000,495000,-45000,-9.09,230,Dublin 18,Leinster
3192,2022-05-25," McDonagh's  Licenced Premises & Residence, on c. 0.6 Acre, Edward Street, Baltinglass, Wicklow ",395000,450000,-55000,-12.22,230,Wicklow,Leinster
3198,2022-05-25," Apartment 91 Kerrymount, Castle Court, Kilgobbin Wood, Sandyford, Dublin ",300000,325000,-25000,-7.69,230,Dublin,Leinster
3199,2022-05-24," Coalpits,Creggs,Co. Galway,F42 KV78 ",140000,130000,10000,7.69,230,Galway,Connaught
3200,2022-05-24," 14 Willbrook Lawn, Whitechurch Road, Rathfarnham, Dublin 14 ",750000,725000,25000,3.45,230,Dublin 14,Leinster
3201,2022-05-24," Apartment Development Site at,Bridewell Lane,Carlow ",125000,135000,-10000,-7.41,231,Carlow,Leinster
3202,2022-05-24," Eagles Rest,Shandrum,Charleville,Co. Cork,P56 WF84 ",285000,325000,-40000,-12.31,231,Cork,Munster
3203,2022-05-24," 9 The Chase, Clonmel, Co. Tipperary ",300000,270000,30000,11.11,231,Tipperary,Munster
3204,2022-05-24," Glannycumnane, Freemount, Co.Cork , Freemount, Cork ",150000,179000,-29000,-16.2,231,Cork,Munster
3205,2022-05-24," 3 Curran Park,Balbriggan,Co. Dublin,K32 FN30 ",299500,315000,-15500,-4.92,231,Dublin,Leinster
3206,2022-05-24," 14 Gleann Ribh, Lusk, Dublin North County, Dublin ",225000,265000,-40000,-15.09,231,Dublin,Leinster
3207,2022-05-24," 3 Cloragh Mills, Edmondstown Road, Rathfarnham, Dublin 16 ",350000,330000,20000,6.06,231,Dublin 16,Leinster
3208,2022-05-24," 14 Whitemaple Drive, Church road, Bundoran, Donegal ",280000,279000,1000,0.36,231,Donegal,Ulster
3209,2022-05-24," 39A Meadow View, Churchtown, Dublin 14 ",550000,525000,25000,4.76,231,Dublin 14,Leinster
3210,2022-05-24," 11 Woodlands, Ballyjamesduff, Co. Cavan ",210000,215000,-5000,-2.33,231,Cavan,Ulster
3215,2022-05-24," Summerbank,Oldcastle,Co.Meath,A82 HP96 ",299995,345000,-45005,-13.04,232,Meath,Leinster
3217,2022-05-24," 5 Lough Lane,Glaslough,Co. Monaghan,H18RH32 ",225000,215000,10000,4.65,232,Monaghan,Ulster
3218,2022-05-23," Knockarudane,Glandore,Co Cork,P81 X524 ",645000,695000,-50000,-7.19,232,Cork,Munster
3220,2022-05-23," Bush House, Powderlough, , Dunshaughlin, Meath ",675000,725000,-50000,-6.9,232,Meath,Leinster
3222,2022-05-23," 13 Gort na Manach, Clonmel, Co. Tipperary ",440000,485000,-45000,-9.28,233,Tipperary,Munster
3223,2022-05-23," 5 & 6 Templars Court, Wexford Town, Wexford ",195000,250000,-55000,-22.0,233,Wexford,Leinster
3224,2022-05-23," Kilmacowen, West Sligo, Sligo ",449000,499000,-50000,-10.02,233,Sligo,Connaught
3225,2022-05-23," 4 Esker Wood Grove, Lucan, Co. Dublin ",375000,349950,25050,7.16,233,Dublin,Leinster
3226,2022-05-23," 5 Brown Court, Youghal, Co. Cork, Youghal, Cork ",175000,160000,15000,9.38,233,Cork,Munster
3227,2022-05-23," 31 Aylesbury, The Sycamores, Kilkenny, Kilkenny ",310000,330000,-20000,-6.06,233,Kilkenny,Leinster
3228,2022-05-23," Apartment 27, The Brosna, Mullingar, Westmeath ",119950,144950,-25000,-17.25,233,Westmeath,Leinster
3229,2022-05-23," Tober, Carricknahorna, Ballyshannon, Donegal ",250000,275000,-25000,-9.09,233,Donegal,Ulster
3231,2022-05-23," Ard Na Domhain, Newtownmountkennedy, Wicklow ",695000,750000,-55000,-7.33,233,Wicklow,Leinster
3232,2022-05-23," Killycarran, Emyvale, Monaghan ",150000,180000,-30000,-16.67,233,Monaghan,Ulster
3235,2022-05-23," 30 Oakpark, Ballyvolane, Cork ",395000,425000,-30000,-7.06,234,Cork,Munster
3236,2022-05-22," Apt 1 The Cutlers Upper Exchange Street Dublin 2, Temple Bar, Dublin 2 ",349750,355000,-5250,-1.48,234,Dublin 2,Leinster
3238,2022-05-21," 3 Dominick Street,Sligo,F91DX2V ",145000,125000,20000,16.0,234,Sligo,Connaught
3239,2022-05-21," 18 Jamestown Rd, Inchicore, Dublin 8 ",640000,495000,145000,29.29,234,Dublin 8,Leinster
3240,2022-05-21," 9.66ha / 23.87ac,Ballymartin,Kilmaine,Co. Mayo ",225000,195000,30000,15.38,234,Mayo,Connaught
3241,2022-05-20," Mountmahon,Abbeyfeale,Co. Limerick,V94 DF8A ",269000,300000,-31000,-10.33,234,Limerick,Munster
3242,2022-05-20," 35 Bulfin Gardens, Kilmainham, Dublin 8 ",600000,475000,125000,26.32,234,Dublin 8,Leinster
3243,2022-05-20," 28 Rathevan Heights,Portlaoise,Co. Laois,R32 YA30 ",155000,175000,-20000,-11.43,234,Laois,Leinster
3245,2022-05-20," Tournagee,Kingsland,Boyle,Co Roscommon ",324900,295000,29900,10.14,234,Roscommon,Connaught
3246,2022-05-20," 1, Haven House, Thomas Hand Street, Skerries, County Dublin ",320000,295000,25000,8.47,234,Dublin,Leinster
3247,2022-05-20," Main Street, Ahascragh, Co. Galway ",50000,40000,10000,25.0,234,Galway,Connaught
3248,2022-05-20," Tubridge More, Keenagh Beg, Ballina, Mayo ",135000,122000,13000,10.66,234,Mayo,Connaught
3249,2022-05-20," Washington Street, Cork City, Cork, T12 NY66 ",850000,700000,150000,21.43,234,Cork,Munster
3250,2022-05-20," 6 The Laurels, Clonsilla Road,, Blanchardstown, Dublin 15 ",255000,325000,-70000,-21.54,234,Dublin 15,Leinster
3251,2022-05-20," 33 O'Growney Drive, Mullingar, Westmeath ",170000,189950,-19950,-10.5,235,Westmeath,Leinster
3252,2022-05-20," 9 Print House Market Place,, Sligo City, Sligo ",145000,120000,25000,20.83,235,Sligo,Connaught
3253,2022-05-20," 57 Milesian Avenue      , Swords, County Dublin ",445000,425000,20000,4.71,235,Dublin,Leinster
3254,2022-05-20," 12 Elm Lawn,Mountmellick Road,Portlaoise,Co. Laois,R32 A8DT ",255000,250000,5000,2.0,235,Laois,Leinster
3255,2022-05-19," 39 Oakpark,Ballymurn,Co. Wexford,Y21 P402 ",269000,285000,-16000,-5.61,235,Wexford,Leinster
3257,2022-05-19," Ban Field, Ardea, Tuosist, Co. Kerry ",285000,275000,10000,3.64,235,Kerry,Munster
3258,2022-05-19," 2 Church Street, Castleblayney, Monaghan ",210000,195000,15000,7.69,235,Monaghan,Ulster
3259,2022-05-19," 48 Shannon Park, Edgeworthstown, Longford ",200000,195000,5000,2.56,235,Longford,Leinster
3260,2022-05-19," 16 Chapel Lane, Edgeworthstown, Longford ",123000,110000,13000,11.82,235,Longford,Leinster
3264,2022-05-19," Scraggeen, Newport, Co. Tipperary ",440000,425000,15000,3.53,236,Tipperary,Munster
3265,2022-05-19," 6 The Bridge, Meagher Street, Dungarvan, Waterford ",195000,200000,-5000,-2.5,236,Waterford,Munster
3266,2022-05-19," Pottore, Aughnasheelin, Co. Leitrim ",175000,229500,-54500,-23.75,236,Leitrim,Connaught
3268,2022-05-19," 63 Tower View,Trim,Co Meath,C15 NH56 ",270000,280000,-10000,-3.57,236,Meath,Leinster
3271,2022-05-18," 2 Collins Park,Shannon,Co Clare,V14 VK84 ",170000,165000,5000,3.03,236,Clare,Munster
3272,2022-05-18," Dromuiri House,Dunmain,Gusserane,Co. Wexford,Y34 F982 ",369500,299500,70000,23.37,237,Wexford,Leinster
3273,2022-05-18," 34 Synge Street, Portobello, Dublin 8 ",675000,725000,-50000,-6.9,237,Dublin 8,Leinster
3276,2022-05-18," O'Riada's Nightclub, Lower Masseytown, Macroom, Cork ",250000,350000,-100000,-28.57,237,Cork,Munster
3277,2022-05-18," 2488 Conroy Park, Kilcullen, Kildare ",230000,250000,-20000,-8.0,237,Kildare,Leinster
3278,2022-05-18," Lub Na HAbhann, Castlecove, Co. Kerry ",215000,205000,10000,4.88,237,Kerry,Munster
3279,2022-05-18," 4, Foxcourt, Balbriggan Street, Skerries, County Dublin ",395000,365000,30000,8.22,237,Dublin,Leinster
3280,2022-05-18," 53 Tyrconnell Road, Inchicore, Dublin 8 ",370000,295000,75000,25.42,237,Dublin 8,Leinster
3281,2022-05-18," 65 Highfield Road, Cavan Town, Co. Cavan ",175000,185000,-10000,-5.41,237,Cavan,Ulster
3282,2022-05-18," Cluainín Innis, Skerries Road, Lusk, Dublin ",995000,1200000,-205000,-17.08,237,Dublin,Leinster
3284,2022-05-18," Ballymachola, Crossmolina, Mayo ",120000,140000,-20000,-14.29,238,Mayo,Connaught
3285,2022-05-18," 57 Castan, Doughiska, Galway City ",215000,227500,-12500,-5.49,238,Galway,Connaught
3286,2022-05-18," 20 Rosse Court Rise, Lucan, Dublin ",249000,269000,-20000,-7.43,238,Dublin,Leinster
3288,2022-05-18," 35 The Drumlins,Virginia,Co.Cavan,A82 R2T4 ",235000,249500,-14500,-5.81,238,Cavan,Ulster
3290,2022-05-18," 11 Scholars Walk,Lusk Village,Lusk,Co Dublin,K45 V523 ",319000,325000,-6000,-1.85,238,Dublin,Leinster
3291,2022-05-18," Lismuse,Kilkee,Co. Clare,V15 C796 ",215000,255000,-40000,-15.69,238,Clare,Munster
3294,2022-05-17," 71 Barrack Street, City Centre Sth, Cork City ",225000,245000,-20000,-8.16,239,Cork,Munster
3295,2022-05-17," 5 Summercove Meadows,Old Road,Cashel,Co Tipperary,E25K526 ",195000,225000,-30000,-13.33,239,Tipperary,Munster
3296,2022-05-17," Residence + c.4.5acres Drumreenagh, Scotshouse, Monaghan ",90000,125000,-35000,-28.0,239,Monaghan,Ulster
3297,2022-05-17," Platform House, Ballymore, Ventry, Kerry ",350000,370000,-20000,-5.41,239,Kerry,Munster
3298,2022-05-17," Townsville, Pearse Square, Youghal, Cork ",495000,550000,-55000,-10.0,239,Cork,Munster
3299,2022-05-17," 15 Chestnut Crescent, Bridgemount, Carrigaline, Cork ",254000,260000,-6000,-2.31,239,Cork,Munster
3300,2022-05-17," Tigh Na Croise, Barnisky, Redcross, Wicklow ",699000,729000,-30000,-4.12,239,Wicklow,Leinster
3301,2022-05-17," No 5 Wallis Street, Mountrath, Laois ",170000,145000,25000,17.24,239,Laois,Leinster
3302,2022-05-17," Glenmore, Athenry, Galway ",15000,39000,-24000,-61.54,239,Galway,Connaught
3303,2022-05-17," 9 Poolboy View,Flowerhill,Navan,Co. Meath,C15 W224 ",130000,80000,50000,62.5,240,Meath,Leinster
3305,2022-05-17," Eastfield House, Friars Park, Dublin Road, Trim, Co Meath ",795000,800000,-5000,-0.63,240,Meath,Leinster
3306,2022-05-16," Old Castlebar Road,Swinford,Co. Mayo ",290000,550000,-260000,-47.27,240,Mayo,Connaught
3307,2022-05-16," Artonagh,Tullyco,Cootehill,Co. Cavan,H16 AW89 ",295000,285000,10000,3.51,240,Cavan,Ulster
3308,2022-05-16," 1 Hillcrest Court, Lucan, Co. Dublin ",320000,315000,5000,1.59,240,Dublin,Leinster
3311,2022-05-16," Sea Spray,Dohooma,Ballina,Co. Mayo,F26 W9D2 ",275000,235000,40000,17.02,240,Mayo,Connaught
3314,2022-05-16," Firmount House, Millicent Road, - on over 7 acres, Clane, Co. Kildare ",1700000,1600000,100000,6.25,241,Kildare,Leinster
3315,2022-05-16," Kilcrimple, Gort, Galway ",25000,35000,-10000,-28.57,241,Galway,Connaught
3316,2022-05-16," Apartment 3 St Mary's Court, Thurles, Tipperary ",120000,110000,10000,9.09,241,Tipperary,Munster
3317,2022-05-16," House Type A, Leighton Manor, Two Mile Borris, Thurles, Tipperary ",450000,399000,51000,12.78,241,Tipperary,Munster
3318,2022-05-16," Apartment 4, THE WEAVERS, Meath Place, South City Centre,   Dublin 8 ",245000,235000,10000,4.26,241,Dublin 8,Leinster
3320,2022-05-16," 30A Thorndale Estate, Dublin Hill, Cork ",215000,235000,-20000,-8.51,241,Cork,Munster
3321,2022-05-15," 112 Swiftwood, Citywest, Saggart, Dublin ",318000,275000,43000,15.64,241,Dublin,Leinster
3322,2022-05-14," No 30 Mount Carmel, New Ross, Wexford ",185000,190000,-5000,-2.63,241,Wexford,Leinster
3323,2022-05-14," 19 Connaught Street Cottages Phibsboro Dublin 7, Phibsboro, Dublin 7 ",378000,400000,-22000,-5.5,241,Dublin 7,Leinster
3324,2022-05-14," 8A O'Briens Range,Templeshannon,Enniscorthy,Co. Wexford,Y21 P8H2 ",130000,150000,-20000,-13.33,241,Wexford,Leinster
3325,2022-05-13," 28 Caheranne Village,Ballyvelly,Tralee,Co Kerry,V92 D7X3 ",195000,175000,20000,11.43,241,Kerry,Munster
3326,2022-05-13," Battery Road, Longford, Longford ",350000,325000,25000,7.69,241,Longford,Leinster
3327,2022-05-13," 4 Premon Heights, Carlingford, Co. Louth ",315000,350000,-35000,-10.0,241,Louth,Leinster
3329,2022-05-13," 21 Carmichael Hall, St Columbanus Road, Dundrum, Dublin 14 ",325000,350000,-25000,-7.14,242,Dublin 14,Leinster
3330,2022-05-13," Leagaun, Moycullen, Galway ",470000,450000,20000,4.44,242,Galway,Connaught
3331,2022-05-13," 414 An Dunnog, Bettystown, Meath ",175000,185000,-10000,-5.41,242,Meath,Leinster
3332,2022-05-13," Oak Lodge, Carntown, Ballymakenny, Drogheda, Louth ",445000,435000,10000,2.3,242,Louth,Leinster
3333,2022-05-13," 31 St. Enda's Road, Terenure,   Dublin 6 ",425000,475000,-50000,-10.53,242,Dublin 6,Leinster
3334,2022-05-13," Knockane, Ballyclough, Mallow, Cork ",290000,280000,10000,3.57,242,Cork,Munster
3335,2022-05-13," 70 Lealand Road, Clondalkin, Dublin 22 ",260000,245000,15000,6.12,242,Dublin 22,Leinster
3336,2022-05-13," ""Teach na Feile"" Crannagh, Summerhill, Athlone, Co. Roscommon ",349000,375000,-26000,-6.93,242,Roscommon,Connaught
3337,2022-05-13," Ashville, Kiltullagh, Galway ",440000,435000,5000,1.15,242,Galway,Connaught
3338,2022-05-13," Wellbank, Flemington South, Mullacash, Naas, Kildare ",1250000,1200000,50000,4.17,242,Kildare,Leinster
3339,2022-05-13," 23 Errew Drive, Mohill, Leitrim ",299500,279000,20500,7.35,242,Leitrim,Connaught
3340,2022-05-13," Manor Cottage, Avoca, Wicklow ",245000,260000,-15000,-5.77,242,Wicklow,Leinster
3341,2022-05-13," 123 North Main Street, Youghal, Cork ",140000,120000,20000,16.67,243,Cork,Munster
3343,2022-05-13," Knockaraha West, Belclare, Westport, Mayo ",340000,385000,-45000,-11.69,243,Mayo,Connaught
3344,2022-05-13," 53 Kilbrody, Mount Oval, Rochestown, Cork ",430000,440000,-10000,-2.27,243,Cork,Munster
3348,2022-05-12," 21D Moore Bay,Kilkee,Co Clare,V15 NY00 ",155000,160000,-5000,-3.13,243,Clare,Munster
3349,2022-05-12," Ballyglassoon, Piltown, Kilkenny ",200000,230000,-30000,-13.04,243,Kilkenny,Leinster
3351,2022-05-12," 175 Huntstown Woods, Mulhuddart, Dublin ",275000,295000,-20000,-6.78,243,Dublin,Leinster
3352,2022-05-12," Denver Lodge,Ballincastle,Cliffoney,Co. Sligo,F91X025 ",485000,500000,-15000,-3.0,243,Sligo,Connaught
3354,2022-05-12," The Sheldon, The Gallops, Clonee, Meath ",985000,925000,60000,6.49,244,Meath,Leinster
3355,2022-05-12," 2 Lee Cottages, Lee Road, Cork City, Cork ",150000,135000,15000,11.11,244,Cork,Munster
3356,2022-05-12," 7 Churchview, Ballinrobe, Mayo ",120000,135000,-15000,-11.11,244,Mayo,Connaught
3357,2022-05-12," 203 Swiftwood, Saggart, Citywest, Dublin 24 ",330000,250000,80000,32.0,244,Dublin 24,Leinster
3358,2022-05-12," 6 Orchard Court, Gorey, Wexford ",290000,305000,-15000,-4.92,244,Wexford,Leinster
3359,2022-05-12," Nico's Takeaway, 289 Richmond Road, Drumcondra, Dublin 3 ",649950,695000,-45050,-6.48,244,Dublin 3,Leinster
3360,2022-05-12," 56 Rathcurragh, Newbridge, Co. Kildare ",310000,325000,-15000,-4.62,244,Kildare,Leinster
3361,2022-05-12," Ballinakill, Ferns, Wexford ",100000,85000,15000,17.65,244,Wexford,Leinster
3363,2022-05-12," 94 Edgewood Lawns, Blanchardstown, Dublin 15 ",280000,290000,-10000,-3.45,244,Dublin 15,Leinster
3365,2022-05-12," 194 Briarwood Lawn, Mulhuddart, Dublin 15 ",315000,335000,-20000,-5.97,244,Dublin 15,Leinster
3366,2022-05-12," Belgrove Park Mount Prospect Lawns, Clontarf, Dublin 3 ",10000,15000,-5000,-33.33,244,Dublin 3,Leinster
3369,2022-05-12," The Bank House, Mainstreet, Kilfinane, Kilfinane, Limerick ",295000,375000,-80000,-21.33,245,Limerick,Munster
3370,2022-05-12," 3 Hampton Wood Avenue, Finglas, Dublin 11 ",299000,345000,-46000,-13.33,245,Dublin 11,Leinster
3371,2022-05-12," 101 Sli an Choiste, Athlone West, Roscommon ",180000,175000,5000,2.86,245,Roscommon,Connaught
3372,2022-05-12," 22 Grange House, Taylor's Hill, Rathfarnham, Dublin 16 ",345000,295000,50000,16.95,245,Dublin 16,Leinster
3373,2022-05-12," Aylsbury House,Carrigduff,Mourneabbey,Mallow,Co.Cork ",365000,345000,20000,5.8,245,Cork,Munster
3375,2022-05-11," The Stone Cottage, Dublin Road, Dunshaughlin, Co. Meath ",325000,375000,-50000,-13.33,245,Meath,Leinster
3376,2022-05-11," 3 Elworth Court, Athlone, Co. Westmeath ",150000,139000,11000,7.91,245,Westmeath,Leinster
3377,2022-05-11," Kilmainham, Kells, Co. Meath ",185000,195000,-10000,-5.13,245,Meath,Leinster
3379,2022-05-11," 17 The Forge, Railway Street, Dublin 1, Dublin ",375000,395000,-20000,-5.06,245,Dublin 1,Leinster
3380,2022-05-11," Development Site,Clarmallagh,The Swan,Co. Laois ",395000,425000,-30000,-7.06,246,Laois,Leinster
3381,2022-05-11," Moymet, Kilbride, Trim, Meath ",575000,550000,25000,4.55,246,Meath,Leinster
3382,2022-05-11," Mirehill, Headford Co Galway, Headford, Galway ",45000,42500,2500,5.88,246,Galway,Connaught
3384,2022-05-11," 42  ABHAINN MOR, Collooney, Sligo ",190000,185000,5000,2.7,246,Sligo,Connaught
3385,2022-05-11," 47 Clonguish Court,Newtownforbes,Co. Longford,N39 X310 ",169500,149500,20000,13.38,246,Longford,Leinster
3386,2022-05-11," 5 Alexandra Court, Alexandra Road, St. Luke's Cross, Cork City, Cork ",395000,350000,45000,12.86,246,Cork,Munster
3387,2022-05-11," Clongill, Donaghpatrick, Navan, Meath ",110000,130000,-20000,-15.38,246,Meath,Leinster
3388,2022-05-11," 37 Barrick Hill, Belturbet, Cavan ",89000,75000,14000,18.67,246,Cavan,Ulster
3389,2022-05-11," 3 Lub na Habhann, Castlecove, Kerry ",215000,205000,10000,4.88,246,Kerry,Munster
3390,2022-05-11,"  22 Botairin Na Muillinn, The Burgery, , Dungarvan, Waterford ",199000,119000,80000,67.23,246,Waterford,Munster
3391,2022-05-11," New Street, Rathangan, Kildare ",150000,175000,-25000,-14.29,246,Kildare,Leinster
3392,2022-05-11," Moorefield House, Berrillstown, Tara, Meath ",1200000,1300000,-100000,-7.69,246,Meath,Leinster
3393,2022-05-11," Oakwood Lodge,Ballykeane,Redcross,Co. Wicklow,A67AH72 ",495000,595000,-100000,-16.81,246,Wicklow,Leinster
3394,2022-05-11," The Hazel Tree,Hazelwood,Mallow,Co. Cork,P51P96X ",650000,750000,-100000,-13.33,246,Cork,Munster
3395,2022-05-10," 6 Greenhill Road, Wicklow Town, Co. Wicklow ",445000,475000,-30000,-6.32,247,Wicklow,Leinster
3396,2022-05-10," Glanworth, Fermoy, Cork ",265000,266000,-1000,-0.38,247,Cork,Munster
3397,2022-05-10," Kildoorus, Clonlara, Clare ",575000,550000,25000,4.55,247,Clare,Munster
3398,2022-05-10," Site at Gracedale, Limekiln Lane, Balgriffin, Dublin ",425000,485000,-60000,-12.37,247,Dublin,Leinster
3399,2022-05-10," 764 Collins Avenue, Whitehall, Dublin 9 ",410000,428000,-18000,-4.21,247,Dublin 9,Leinster
3401,2022-05-10," 30 Flesk Grove, Ballycasheen, Killarney, Kerry ",390000,370000,20000,5.41,247,Kerry,Munster
3402,2022-05-10," Apartment 7, Whispering Heights, Lamberton, Arklow, Wicklow ",199000,215000,-16000,-7.44,247,Wicklow,Leinster
3404,2022-05-10," 23 Singleton Cottages, Mell, Drogheda, Louth ",200000,205000,-5000,-2.44,247,Louth,Leinster
3406,2022-05-10," Annamoe, Annamoe, Wicklow ",250000,280000,-30000,-10.71,247,Wicklow,Leinster
3407,2022-05-10," Kellistown, Rathoe, Carlow ",495000,549000,-54000,-9.84,247,Carlow,Leinster
3408,2022-05-10," 105 Baggot Street Lower, Baggot Street, Dublin 2 ",1595000,1750000,-155000,-8.86,247,Dublin 2,Leinster
3409,2022-05-10," Moat, Aughrim, Ballinasloe, Galway ",279500,269500,10000,3.71,248,Galway,Connaught
3410,2022-05-10," 34 Portside,Rosslare Harbour,Co. Wexford,Y35 XC93 ",229000,245000,-16000,-6.53,248,Wexford,Leinster
3411,2022-05-10," Woodside,Kilmallock,Ballymurn,Co. Wexford,Y21 W681 ",399000,450000,-51000,-11.33,248,Wexford,Leinster
3413,2022-05-09," Woodbrook House, Main Street, Abbeyleix, Laois ",450000,379000,71000,18.73,248,Laois,Leinster
3414,2022-05-09," Gorteengrone,Carlow,R93 A6X0 ",495000,465000,30000,6.45,248,Carlow,Leinster
3415,2022-05-09," Butlersgift,Drimoleague,Co. Cork,P47FD82 ",195000,369000,-174000,-47.15,248,Cork,Munster
3417,2022-05-09," 10 Colthurst Mews, Lucan, Co. Dublin ",440000,430000,10000,2.33,248,Dublin,Leinster
3418,2022-05-09," 10 The Jetty Market Point, Mullingar, Westmeath ",165000,155000,10000,6.45,248,Westmeath,Leinster
3419,2022-05-09," 131 Herberton Road, Rialto, Dublin 8 ",545000,450000,95000,21.11,248,Dublin 8,Leinster
3420,2022-05-09," 96 Castlegate, Portarlington, Laois ",269000,275000,-6000,-2.18,248,Laois,Leinster
3423,2022-05-09," Ballybranigan, Kinvara, Galway ",55000,75000,-20000,-26.67,249,Galway,Connaught
3425,2022-05-09," 40 Paírc na Fána, Union Hall, West Cork, Cork ",350000,320000,30000,9.38,249,Cork,Munster
3426,2022-05-09," Fringerstown, Castletown, Meath ",310000,340000,-30000,-8.82,249,Meath,Leinster
3427,2022-05-09," 40 Pairc Na Fana, Union Hall,   West Cork ",350000,325000,25000,7.69,249,Cork,Munster
3428,2022-05-08," Cavan Lodge, Ballinrobe, Mayo ",175000,195000,-20000,-10.26,249,Mayo,Connaught
3429,2022-05-07," Take Away & Apartment,Main Street,Camolin,Gorey,Co. Wexford ",250000,300000,-50000,-16.67,249,Wexford,Leinster
3430,2022-05-07," 4 Jamestown Square, Inchicore, Dublin 8 ",330000,295000,35000,11.86,249,Dublin 8,Leinster
3431,2022-05-06," Glen View,Glandart,Bantry,Co. Cork,P75 YH04 ",395000,415000,-20000,-4.82,249,Cork,Munster
3432,2022-05-06," Ardbraccan Village, Navan, Co. Meath, Navan, Meath ",335000,355000,-20000,-5.63,249,Meath,Leinster
3433,2022-05-06," 50 Ard Na Slaine,Newtown Road,Wexford Town ",450000,475000,-25000,-5.26,249,Wexford,Leinster
3434,2022-05-06," 48 Ard Na Slaine,Newtown Road,Wexford Town ",450000,475000,-25000,-5.26,249,Wexford,Leinster
3436,2022-05-06," Bank House,The Harbour,Kilcock,Co Kildare,W23 R682 ",850000,600000,250000,41.67,250,Kildare,Leinster
3438,2022-05-06," 66 Alderpark Court, Tallaght, Dublin 24 ",215000,229950,-14950,-6.5,250,Dublin 24,Leinster
3439,2022-05-06," 148 Grange Lodge Avenue, Clongriffin, Dublin 13 ",385000,395000,-10000,-2.53,250,Dublin 13,Leinster
3441,2022-05-06," Wardenstown, Killucan, Westmeath ",295000,325000,-30000,-9.23,250,Westmeath,Leinster
3442,2022-05-06," Apt. 27 The Locks, Charlotte Quay, Grand Canal Dk, Dublin 4 ",645000,675000,-30000,-4.44,250,Dublin 4,Leinster
3443,2022-05-06," 11 The Woodlands,Mount Falcon,Ballina,Co Mayo,F26 N6C8 ",290000,310000,-20000,-6.45,250,Mayo,Connaught
3444,2022-05-06," 15 Halliday Square , Stoneybatter, Dublin 7 ",495000,485000,10000,2.06,250,Dublin 7,Leinster
3445,2022-05-06," Cornarone, Inverin, Co. Galway ",440000,470000,-30000,-6.38,250,Galway,Connaught
3446,2022-05-06," 1A Pairc Cluain, Mulgannon, Wexford Town, Wexford ",215000,225000,-10000,-4.44,250,Wexford,Leinster
3447,2022-05-06," 123 Collins Avenue East, Killester, Dublin 5 ",395000,365000,30000,8.22,250,Dublin 5,Leinster
3449,2022-05-06," 14 Laoi na Mara, Dunmore East, Co. Waterford ",135000,145000,-10000,-6.9,250,Waterford,Munster
3450,2022-05-06," 24 Faulkners Terrace, Kilmainham, Dublin 8 ",360000,325000,35000,10.77,251,Dublin 8,Leinster
3452,2022-05-05," 26 Ravenswell, Rush, Dublin ",380000,350000,30000,8.57,251,Dublin,Leinster
3453,2022-05-05," 186 The Park, Alderbrook, Ashbourne, Meath ",575000,625000,-50000,-8.0,251,Meath,Leinster
3454,2022-05-05," 8B Moyacomb, Clonegal, Co. Carlow ",195000,199000,-4000,-2.01,251,Carlow,Leinster
3456,2022-05-05," Apt 115 Seamount Apts, Booterstown, County Dublin ",295000,315000,-20000,-6.35,251,Dublin,Leinster
3457,2022-05-05," 17 St Andrews Wood, Lucan, Dublin ",435000,425000,10000,2.35,251,Dublin,Leinster
3458,2022-05-05," 12 Westbrook Drive,Balbriggan,Co Dublin,K32 YN47 ",325000,315000,10000,3.17,251,Dublin,Leinster
3459,2022-05-05," Raheen,Beech Road,Arklow,Co. Wicklow,Y14PH00 ",650000,725000,-75000,-10.34,251,Wicklow,Leinster
3460,2022-05-05," 2 Knocklaun , Ballyhooly Road, St. Lukes, Cork City, Cork ",510000,460000,50000,10.87,251,Cork,Munster
3461,2022-05-05," Apt 314 Abbey River Court ,Sheep Street, City Centre (Limerick),   Limerick City ",160000,145000,15000,10.34,251,Limerick,Munster
3462,2022-05-05," 66 Rathbraughan Park, Sligo City, Sligo ",120000,115000,5000,4.35,251,Sligo,Connaught
3463,2022-05-05," 89 Tyrconnell Rd, Inchicore, Dublin 8 ",435000,395000,40000,10.13,252,Dublin 8,Leinster
3464,2022-05-05," 30 Dooleys Terrace , Athy, Kildare ",135000,130000,5000,3.85,252,Kildare,Leinster
3465,2022-05-05," Woodroofe, Clonmel, Tipperary ",350000,390000,-40000,-10.26,252,Tipperary,Munster
3466,2022-05-05," 130 Butterfield Park, Rathfarnham, Dublin 14 ",595000,695000,-100000,-14.39,252,Dublin 14,Leinster
3467,2022-05-05," 34 Slieve Bloom Heights, Rathdowney, Laois ",240000,210000,30000,14.29,252,Laois,Leinster
3468,2022-05-05," 4 Cluain Aoibheann,Shannon,Co Clare,V14 YH67 ",250000,240000,10000,4.17,252,Clare,Munster
3469,2022-05-04," Apartment 3, Lower Waterford Road, Carrick Beg, Carrick on Suir, Carrick-on-Suir, Co. Tipperary ",100000,105000,-5000,-4.76,252,Tipperary,Munster
3471,2022-05-04," Rath,Danesfort,Co Kilkenny,R95 FV07 ",325000,295000,30000,10.17,252,Kilkenny,Leinster
3472,2022-05-04," 2 Irwin Court, Kilmainham, Dublin 8 ",520000,445000,75000,16.85,252,Dublin 8,Leinster
3473,2022-05-04," Cloverhill, Co. Roscommon ",85000,100000,-15000,-15.0,252,Roscommon,Connaught
3474,2022-05-04," Block 3, The Watermill, Watermill Road, Raheny, Dublin 5, Raheny, Dublin 5 ",310000,325000,-15000,-4.62,252,Dublin 5,Leinster
3475,2022-05-04," 29 Verbena Ave, Sutton, Dublin 13 ",489950,495950,-6000,-1.21,253,Dublin 13,Leinster
3476,2022-05-04," 5 Waterville, Athlone West, Roscommon ",320000,330000,-10000,-3.03,253,Roscommon,Connaught
3477,2022-05-04," 21 Ounavarra, Gorey, Wexford ",175000,185000,-10000,-5.41,253,Wexford,Leinster
3480,2022-05-04," 5 Templeview Park, Clarehall, Dublin ",375000,395000,-20000,-5.06,253,Dublin,Leinster
3481,2022-05-04," Carrigfadda House, Reenascreena, Clonakilty , Clonakilty, West Cork ",390000,400000,-10000,-2.5,253,Cork,Munster
3482,2022-05-04," Annaghkeen, Headford, Galway ",35000,37500,-2500,-6.67,253,Galway,Connaught
3484,2022-05-04," Gardenfield, Hollymount, Mayo ",32500,30000,2500,8.33,253,Mayo,Connaught
3485,2022-05-04," Brackloon, Shrule, Mayo ",30000,25000,5000,20.0,253,Mayo,Connaught
3486,2022-05-04," 1 31 St James Walk, Rialto, Dublin ",320000,275000,45000,16.36,253,Dublin,Leinster
3487,2022-05-04," 8 St John's Cottages, Kilmainham, Dublin 8 ",540000,450000,90000,20.0,253,Dublin 8,Leinster
3488,2022-05-04," Yew Tree House,Commons North,Suncroft,The Curragh,Co. Kildare ",450000,385000,65000,16.88,254,Kildare,Leinster
3489,2022-05-03," 28 Mount Rochford Avenue,Balbriggan,Co. Dublin,K32 AK59 ",335000,295000,40000,13.56,254,Dublin,Leinster
3490,2022-05-03," 11 Ard Bhearu,Cois Bhearu,Athy,Co. Kildare,R14 K821 ",285000,295000,-10000,-3.39,254,Kildare,Leinster
3493,2022-05-03," 7 Fieldstone, Tramore, Waterford ",465000,475000,-10000,-2.11,254,Waterford,Munster
3494,2022-05-03," 7 Cul Na Coille,Tulla Road,Ennis,Co Clare,V95 PFK2 ",475000,395000,80000,20.25,254,Clare,Munster
3495,2022-05-03," Faha Demesne, Patrickswell, Limerick ",65000,48000,17000,35.42,254,Limerick,Munster
3496,2022-05-03," 11 Lower Rutland Street, North City Centre, Dublin ",170000,195000,-25000,-12.82,254,Dublin,Leinster
3499,2022-05-03," 120 Monread Heights, Naas, Kildare ",360000,375000,-15000,-4.0,254,Kildare,Leinster
3500,2022-04-30," The Oval, Eyeries Village, Eyeries, West Cork ",275000,215000,60000,27.91,255,Cork,Munster
3501,2022-04-30," 13, Rosmeen Court, Lower Salthill, Salthill, Galway City, H91TN36 ",278000,267500,10500,3.93,255,Galway,Connaught
3502,2022-04-30," 28 Nash Street, Inchicore, Dublin 8 ",300000,265000,35000,13.21,255,Dublin 8,Leinster
3504,2022-04-30," Trinity House,Priory St.,New Ross,Co. Wexford ",160000,195000,-35000,-17.95,255,Wexford,Leinster
3505,2022-04-29," O'Neill Car Sales,Cahir Road,Cashel,Co Tipperary,E25XP76 ",350000,395000,-45000,-11.39,255,Tipperary,Munster
3507,2022-04-29," Breanamore, Loughlynn, Loughglynn, Co. Roscommon ",145000,120000,25000,20.83,255,Roscommon,Connaught
3509,2022-04-29," 27 Glenrichards Cove,Poulshone,Co. Wexford,Y25 T208 ",185000,195000,-10000,-5.13,256,Wexford,Leinster
3510,2022-04-29," Sheil Avenue, Bundoran, Donegal ",285000,240000,45000,18.75,256,Donegal,Ulster
3511,2022-04-29," 110 Fassaugh Road, Cabra, Dublin 7 ",410000,420000,-10000,-2.38,256,Dublin 7,Leinster
3513,2022-04-29," 49 Inchicore Rd, Kilmainham, Dublin 8 ",480000,395000,85000,21.52,256,Dublin 8,Leinster
3514,2022-04-29," 173 Millbrook, Johnstown, Navan, Co. Meath, Johnstown, Meath ",257500,255000,2500,0.98,256,Meath,Leinster
3515,2022-04-29," Mulhussey, Maynooth, Maynooth, Kildare ",695000,725000,-30000,-4.14,256,Kildare,Leinster
3516,2022-04-29," REDUCED RESERVE! - Service Station/Forecourt/Retail Unit/Residence, Templeglantine, Limerick ",350000,375000,-25000,-6.67,256,Limerick,Munster
3517,2022-04-29," No. 25 Rockvale , Castlebar, Mayo ",190000,152500,37500,24.59,256,Mayo,Connaught
3519,2022-04-28," Waterford Crystal Centre,Ballinaneeshagh,Cork Road,Waterford ",950000,1300000,-350000,-26.92,256,Cork,Munster
3520,2022-04-28," Leamonaghan,Ballycumber,Co Offaly,R35EA22 ",230000,240000,-10000,-4.17,257,Offaly,Leinster
3521,2022-04-28," 21 Wingfield, Enniskerry Road, Stepaside, Dublin 18 ",335000,350000,-15000,-4.29,257,Dublin 18,Leinster
3522,2022-04-28," 30 Ashthorn Avenue, Headford, Galway ",275000,265000,10000,3.77,257,Galway,Connaught
3523,2022-04-28," 4 Beechdale, Dunboyne, Meath ",475000,440000,35000,7.95,257,Meath,Leinster
3524,2022-04-28," 5, Ashmore, Pembroke Woods, Passage West, Cork ",335000,360000,-25000,-6.94,257,Cork,Munster
3527,2022-04-28," Riverwalk House, Oughterard, Co. Galway ",595000,650000,-55000,-8.46,257,Galway,Connaught
3530,2022-04-28," Cloonbard, Ballinagare, Roscommon ",22000,15000,7000,46.67,257,Roscommon,Connaught
3531,2022-04-28," 2 Westbury Heights, Ballincollig, Cork ",395000,420000,-25000,-5.95,258,Cork,Munster
3533,2022-04-27," Lime Avenue,Kilnamoragh South,Donadea,Co Kildare ",200000,250000,-50000,-20.0,258,Kildare,Leinster
3534,2022-04-27," 127 Childers Heights , Ballina, Mayo ",185000,180000,5000,2.78,258,Mayo,Connaught
3536,2022-04-27," 14 Seaview Avenue North, Clontarf, Dublin 3 ",610000,595000,15000,2.52,258,Dublin 3,Leinster
3537,2022-04-27," Apt 105 Longboat Quay North, Grand Canal Dk, Dublin 2, D02KX70 ",590000,560000,30000,5.36,258,Dublin 2,Leinster
3538,2022-04-27," Cloontowart, Lisacul, Castlerea, Roscommon ",152000,130000,22000,16.92,258,Roscommon,Connaught
3539,2022-04-27," 106 Cubes 1, Beacon South Quarter, Sandyford, Dublin 18 ",390000,375000,15000,4.0,259,Dublin 18,Leinster
3540,2022-04-27," ""Meadowview"" 1 Grange End, Dunshaughlin, Meath ",795000,875000,-80000,-9.14,259,Meath,Leinster
3541,2022-04-27," 20 Linenhall Street, Smithfield, Dublin 7 ",385000,325000,60000,18.46,259,Dublin 7,Leinster
3542,2022-04-27," 37 Meadowbrook Park, Baldoyle, Dublin 13 ",450000,395000,55000,13.92,259,Dublin 13,Leinster
3543,2022-04-27," 18 O'Mahoney Avenue, Bandon,   West Cork ",150000,140000,10000,7.14,259,Cork,Munster
3544,2022-04-27," Riverwalk House,Riverside,Oughterard,Co Galway,H91 YX90 ",595000,650000,-55000,-8.46,259,Galway,Connaught
3545,2022-04-27," Chancery, Turlough , Castlebar, Mayo ",210000,215000,-5000,-2.33,259,Mayo,Connaught
3546,2022-04-27," 6 Malachi Road, Stoneybatter, Dublin 7 ",325000,355000,-30000,-8.45,259,Dublin 7,Leinster
3547,2022-04-27," Masreagh,Skreen,Co. Sligo,F91CF99 ",179000,170000,9000,5.29,260,Sligo,Connaught
3548,2022-04-26," Kingsview,Boscabell,Cashel,Co. Tipperary,E25PK38 ",575000,495000,80000,16.16,260,Tipperary,Munster
3551,2022-04-26," 33 Kells Road, Crumlin, Dublin 12 ",350000,365000,-15000,-4.11,260,Dublin 12,Leinster
3555,2022-04-26," Derryinver, Letterfrack, Galway ",399000,450000,-51000,-11.33,260,Galway,Connaught
3556,2022-04-26," 19 Limekiln Wood,Dublin Road,Navan,Co Meath,C15 WR2R ",320000,295000,25000,8.47,261,Meath,Leinster
3558,2022-04-25," Ballygeary, Rosslare, Co. Wexford ",1000000,750000,250000,33.33,261,Wexford,Leinster
3559,2022-04-25," 18, Golf links Road, Skerries, County Dublin, K34HD28 ",520000,470000,50000,10.64,261,Dublin,Leinster
3560,2022-04-25," Ballysally,Charleville,Co Cork,P56 T259 ",225000,250000,-25000,-10.0,261,Cork,Munster
3561,2022-04-25," Commercial and Residential,Dromore West,Co Sligo,F26 N2R4 ",220000,200000,20000,10.0,261,Sligo,Connaught
3563,2022-04-25," 6 St Thomas Road, South Circular Road, Dublin 8 ",350000,395000,-45000,-11.39,261,Dublin 8,Leinster
3564,2022-04-25," 34 Ballyhooly Road, Dillons Cross, Cork, Cork City, Cork ",235000,205000,30000,14.63,261,Cork,Munster
3565,2022-04-25," 18 Heathfields, Dublin Road, Portlaoise, Laois ",240000,220000,20000,9.09,261,Laois,Leinster
3566,2022-04-25," Rafwee, Headford, Galway ",170000,175000,-5000,-2.86,261,Galway,Connaught
3567,2022-04-25," 7 Knocklaun Ballyhooly Road, St Lukes, Cork City ",370000,270000,100000,37.04,261,Cork,Munster
3568,2022-04-25," 17 Greenmount Court HX, Harold's Cross - D12, Dublin 12 ",750000,840000,-90000,-10.71,261,Dublin 12,Leinster
3570,2022-04-23," Apartment 130, Millrace Road, Phoenix Park, Castleknock, Dublin 15 ",370000,350000,20000,5.71,262,Dublin 15,Leinster
3571,2022-04-23," Cleenrath , Aughnacliffe, Longford ",150000,140000,10000,7.14,263,Longford,Leinster
3572,2022-04-22," ""New Abbey Lodge"", Brannockstown, Naas, Kildare ",495000,550000,-55000,-10.0,263,Kildare,Leinster
3573,2022-04-22," New Abbey Lodge, New Abbey, Kilcullen, Kildare ",495000,550000,-55000,-10.0,263,Kildare,Leinster
3574,2022-04-22," 11 Barnwell Gate, Hansfield, Clonsilla, Dublin 15 ",520000,500000,20000,4.0,263,Dublin 15,Leinster
3575,2022-04-22," 200 Brightwater, Crosshaven, Cork ",260000,250000,10000,4.0,263,Cork,Munster
3576,2022-04-22," 28 Acre Site, Bagenalstown, Carlow ",5600000,5000000,600000,12.0,263,Carlow,Leinster
3578,2022-04-22," 55 Millbank Square, Sallins, Kildare ",169000,175000,-6000,-3.43,264,Kildare,Leinster
3579,2022-04-22," Type B, Árd Alainn, Innishannon, Cork ",620000,645000,-25000,-3.88,264,Cork,Munster
3581,2022-04-22," Convent Hill Crescent, Ballina, Mayo ",135000,160000,-25000,-15.63,264,Mayo,Connaught
3582,2022-04-21," H Type - 3 Bed Semi-Detached,Oak Church,Kildare,Co. Kildare ",365000,355000,10000,2.82,264,Kildare,Leinster
3583,2022-04-21," L Type - 3 Bed Semi-Detached,Oak Church,Kildare,Co. Kildare ",345000,330000,15000,4.55,264,Kildare,Leinster
3586,2022-04-21," 11 Clearwater Cove, Dun Laoghaire, County Dublin ",319950,329950,-10000,-3.03,264,Dublin,Leinster
3587,2022-04-21," Drumnasorna, Dunkineely, Donegal ",165000,145000,20000,13.79,264,Donegal,Ulster
3589,2022-04-21," At Circular Road, Roscommon, Roscommon ",450000,400000,50000,12.5,264,Roscommon,Connaught
3590,2022-04-21," 51 St James Court, Kilmainham, Dublin 8 ",395000,345000,50000,14.49,265,Dublin 8,Leinster
3591,2022-04-21," 5 Beechwood Avenue,Ballyjamesduff,Co.Cavan,A82 V0F6 ",199500,215000,-15500,-7.21,265,Cavan,Ulster
3592,2022-04-21," Illaune Lea,Kilshannig,Castlegregory,Co Kerry,V92 C8C9 ",260000,230000,30000,13.04,265,Kerry,Munster
3593,2022-04-21," 2 Elm Park,Ballinode,Sligo,F91C4E9 ",249000,265000,-16000,-6.04,265,Sligo,Connaught
3594,2022-04-20," Ard Na Si, Mohill, Leitrim ",215000,225000,-10000,-4.44,265,Leitrim,Connaught
3595,2022-04-20," Ballyscartin, Gorey, Wexford ",595000,649000,-54000,-8.32,265,Wexford,Leinster
3596,2022-04-20," Apartment 3 Green Trees, Cleveragh Road, Sligo City, Sligo ",175000,150000,25000,16.67,265,Sligo,Connaught
3597,2022-04-20," 69 Abbottstown Road, Finglas, Dublin 11 ",249950,269950,-20000,-7.41,265,Dublin 11,Leinster
3598,2022-04-20," Type A1 - Three Bed Semi Detached,Harbour Heights,Rochestown Road,Cork ",365000,345000,20000,5.8,265,Cork,Munster
3599,2022-04-20," Type B2 - Four Bed Semi Detached,Harbour Heights,Rochestown Road,Cork ",410000,405000,5000,1.23,265,Cork,Munster
3600,2022-04-20," Type A3 - Three Bed Mid/End Terrace,Harbour Heights,Rochestown Road,Cork ",335000,320000,15000,4.69,265,Cork,Munster
3602,2022-04-20," Unit C Southgate Cork Street, South City Centre - D8, Dublin 8 ",199950,249950,-50000,-20.0,265,Dublin 8,Leinster
3603,2022-04-20," 33 Riverview, New Ross, Wexford ",285000,275000,10000,3.64,265,Wexford,Leinster
3604,2022-04-20," Abbeywest, Bellharbour, Clare ",35000,65000,-30000,-46.15,266,Clare,Munster
3605,2022-04-20," ""Lothlorian"" Bachelors Walk, Shillelagh, Wicklow ",199000,225000,-26000,-11.56,266,Wicklow,Leinster
3607,2022-04-20," 31 Railway Avenue, Inchicore, Dublin 8 ",340000,325000,15000,4.62,266,Dublin 8,Leinster
3608,2022-04-20," Unit 6 Longford Retail Park Athlone Road, Longford, Longford ",175000,220000,-45000,-20.45,266,Longford,Leinster
3609,2022-04-20," 1 Bayswater Terrace, Breffni Road, Sandycove, Co. Dublin ",2500000,2750000,-250000,-9.09,266,Dublin,Leinster
3610,2022-04-20," Unit 7 Longford Retail Park Athlone Road, Longford, Longford ",220000,175000,45000,25.71,266,Longford,Leinster
3611,2022-04-20," 5 Devoy Rd, Inchicore, Dublin 8 ",365000,325000,40000,12.31,266,Dublin 8,Leinster
3612,2022-04-20," 6 Saint Mary's Crescent, Fermoy, Cork ",125000,95000,30000,31.58,266,Cork,Munster
3613,2022-04-20," Rear Market St.,, Listowel, Kerry ",100000,150000,-50000,-33.33,266,Kerry,Munster
3614,2022-04-20," 30 Heather Lawn, Rathfarnham, Dublin 16 ",550000,525000,25000,4.76,266,Dublin 16,Leinster
3619,2022-04-19," 50 Abbey Park, Ferrybank, Waterford ",209000,225000,-16000,-7.11,267,Waterford,Munster
3621,2022-04-19," Ballinahinch,O'Callaghan Mills,Co. Clare,V94 W8YC ",200000,160000,40000,25.0,267,Clare,Munster
3622,2022-04-19," Orchardstown, Butlerstown, Co. Waterford, Butlerstown, Waterford ",465000,485000,-20000,-4.12,267,Waterford,Munster
3625,2022-04-19," 9 Morrisons Avenue, Waterford City, Waterford ",169500,179500,-10000,-5.57,267,Waterford,Munster
3626,2022-04-19," 15 Bruach Abhainn, Mogeely, Midleton, Cork ",480000,465000,15000,3.23,267,Cork,Munster
3627,2022-04-19," Bruach Abhainn, Mogeely, Midleton, Cork ",480000,445000,35000,7.87,267,Cork,Munster
3628,2022-04-19," Duntryleague , Garryspillane, Limerick ",325000,300000,25000,8.33,267,Limerick,Munster
3630,2022-04-15," The Old Schoolhouse, Lauragh, Kenmare, Kerry ",395000,295000,100000,33.9,267,Kerry,Munster
3631,2022-04-15," 51 Cois Abhainn, Tralee, Kerry ",145000,135000,10000,7.41,267,Kerry,Munster
3632,2022-04-14," Sleepy Hollow,Thornfield,Lisnagry,Co Limerick,V94 Y7Y8 ",850000,825000,25000,3.03,267,Limerick,Munster
3633,2022-04-14," 1 Ardeevin, Ahiohill, Enniskeane,   West Cork ",550000,500000,50000,10.0,268,Cork,Munster
3634,2022-04-14," 40 Caireal Mor, Headford Road, Galway City ",180000,195000,-15000,-7.69,268,Galway,Connaught
3635,2022-04-14," ""Sli an Eala"", Durrow, Tullamore, Offaly ",270000,325000,-55000,-16.92,268,Offaly,Leinster
3637,2022-04-14," 12 Somers Way, Ballycullane, Wexford ",175000,155000,20000,12.9,268,Wexford,Leinster
3638,2022-04-14," 5 Castle Manor Court, Ferns, Co. Wexford ",200000,180000,20000,11.11,268,Wexford,Leinster
3639,2022-04-14," Ballinorig West, Tralee, Kerry ",235000,240000,-5000,-2.08,268,Kerry,Munster
3640,2022-04-14," 17 Infirmary Road , Stoneybatter, Dublin 7 ",445000,435000,10000,2.3,268,Dublin 7,Leinster
3641,2022-04-13," 37 Georges Avenue, Blackrock, Co. Dublin ",950000,850000,100000,11.76,268,Dublin,Leinster
3644,2022-04-13," 41 Bridgewater Quay, Islandbridge, Dublin 8 ",585000,495000,90000,18.18,268,Dublin 8,Leinster
3645,2022-04-13," Clooneen, Gurteen, Sligo ",210000,198000,12000,6.06,268,Sligo,Connaught
3646,2022-04-13," 93 Coill Tire , Doughiska, Galway City ",225000,215000,10000,4.65,268,Galway,Connaught
3647,2022-04-13," 6 Cois Cuaine, Bellharbour, Clare ",195000,215000,-20000,-9.3,268,Clare,Munster
3648,2022-04-13," 3 Southern Cross Avenue, Inchicore, Dublin 8 ",460000,395000,65000,16.46,268,Dublin 8,Leinster
3649,2022-04-13," J Walsh,Clogagh,Timoleague,Co Cork,P72 WA07 ",195000,215000,-20000,-9.3,268,Cork,Munster
3650,2022-04-13," College Green, Mortarstown, Carlow Town, Carlow ",265000,240000,25000,10.42,269,Carlow,Leinster
3653,2022-04-13," Apartment 3, 1 Railway Road, Clongriffin, Dublin 13 ",195000,199950,-4950,-2.48,269,Dublin 13,Leinster
3655,2022-04-13," 23 The Close, Citywest, Dublin 24, Dublin ",455000,395000,60000,15.19,269,Dublin,Leinster
3656,2022-04-13," 34 Riverwalk, Gort, Galway ",259000,275000,-16000,-5.82,269,Galway,Connaught
3657,2022-04-13," Unit C Southgate, Cork St, South City Centre, Dublin 8 ",199950,249950,-50000,-20.0,269,Dublin 8,Leinster
3658,2022-04-13," 12 Asgard Avenue, Waterford City, Waterford ",220000,230000,-10000,-4.35,269,Waterford,Munster
3659,2022-04-13," 63 Gracedieu Road, undefined, Co. Waterford ",160000,195000,-35000,-17.95,269,Waterford,Munster
3660,2022-04-13," Laheratanvally, Skibbereen, West Cork. P81DC80 ",600000,550000,50000,9.09,269,Cork,Munster
3661,2022-04-13," 7 Milltown Gate, Blessington, Wicklow ",385000,395000,-10000,-2.53,269,Wicklow,Leinster
3665,2022-04-12," Gannoughs, Claddaghduff, Galway ",40000,65000,-25000,-38.46,269,Galway,Connaught
3667,2022-04-12," Rathmanna, Thurles, Tipperary ",248000,295000,-47000,-15.93,270,Tipperary,Munster
3668,2022-04-12," Ballanagh, Avoca, Wicklow ",250000,180000,70000,38.89,270,Wicklow,Leinster
3669,2022-04-12," 31 Tory Square, Waterville, Blanchardstown, Dublin 15 ",300000,350000,-50000,-14.29,270,Dublin 15,Leinster
3670,2022-04-12," 13 Abbey Court, Abbey Farm, Celbridge, Co. Kildare ",470000,495000,-25000,-5.05,270,Kildare,Leinster
3671,2022-04-12," 179 Shingan, Milehouse Road, Enniscorthy, Co. Wexford , Enniscorthy, Wexford ",127500,130000,-2500,-1.92,270,Wexford,Leinster
3672,2022-04-12," Ranagissaun, Kilmovee, Mayo ",239000,209000,30000,14.35,270,Mayo,Connaught
3673,2022-04-11," 3 Grange Park Drive, Raheny, Dublin 5 ",480000,445000,35000,7.87,270,Dublin 5,Leinster
3674,2022-04-11," 2 Emerson Way, Prosperous, Co. Kildare ",270000,295000,-25000,-8.47,270,Kildare,Leinster
3675,2022-04-11," 764, Collins Avenue Extension , Whitehall, Dublin 9., Whitehall, Dublin 9 ",410000,428000,-18000,-4.21,270,Dublin 9,Leinster
3676,2022-04-11," 34 Ginnell Terrace, Mullingar, Westmeath ",167500,174950,-7450,-4.26,270,Westmeath,Leinster
3678,2022-04-11," 35 Ring Terrace, Inchicore, Dublin 8 ",325000,275000,50000,18.18,271,Dublin 8,Leinster
3679,2022-04-11," Bridge Street, Dunmanway,   West Cork ",125000,150000,-25000,-16.67,271,Cork,Munster
3680,2022-04-11," Mountbolus, Tullamore, Offaly ",249000,260000,-11000,-4.23,271,Offaly,Leinster
3681,2022-04-11," Ashleaf House, Great Connell, Newbridge, Kildare ",550000,545000,5000,0.92,271,Kildare,Leinster
3682,2022-04-11," Kilodiernan, Puckane, Tipperary ",199500,195000,4500,2.31,271,Tipperary,Munster
3684,2022-04-11," 15 Moyne Court, Moyne Road, Ranelagh, Dublin 6 ",570000,595000,-25000,-4.2,271,Dublin 6,Leinster
3685,2022-04-08," Laheratanvally, Aughadown, Skibbereen, West Cork, P81 VO49 ",495000,550000,-55000,-10.0,271,Cork,Munster
3686,2022-04-08," Airport Manor,Ballycasey,Shannon,Co Clare,V14 RC64 ",730000,650000,80000,12.31,271,Clare,Munster
3687,2022-04-08," Ashfield House, Trim Road, Athboy, Meath ",440000,475000,-35000,-7.37,271,Meath,Leinster
3688,2022-04-08," Knockybrin, Woodlands, Letterkenny, Donegal ",525000,495000,30000,6.06,272,Donegal,Ulster
3689,2022-04-08," Yellow Furze, Beauparc, Navan, Navan, Meath ",385000,360000,25000,6.94,272,Meath,Leinster
3690,2022-04-08," Croaghan, Virginia, Cavan ",295000,250000,45000,18.0,272,Cavan,Ulster
3691,2022-04-08," 10 Emerson Way,Prosperous,Co. Kildare,W91 E227 ",275000,299000,-24000,-8.03,272,Kildare,Leinster
3693,2022-04-08," 16 Carrick Street, Kells, Co. Meath ",125000,130000,-5000,-3.85,272,Meath,Leinster
3694,2022-04-08," 1 Columba Terrace, Kells, Co. Meath ",165000,180000,-15000,-8.33,272,Meath,Leinster
3695,2022-04-08," Elmwood Lodge,Frankfield, Grange, Cork City ",675000,700000,-25000,-3.57,272,Cork,Munster
3696,2022-04-08," 1 The Millicent, Cois Abhainn, Clane, Kildare ",219000,214000,5000,2.34,272,Kildare,Leinster
3697,2022-04-08," Gleann na Mona, Ballymoneen Road, Knocknacarra, Galway City ",245000,255000,-10000,-3.92,272,Galway,Connaught
3698,2022-04-08," Cashleen, Renvyle, Galway ",295000,310000,-15000,-4.84,272,Galway,Connaught
3699,2022-04-08," Apartment 14 Churchview, Main Street, Ratoath, Meath ",240000,225000,15000,6.67,272,Meath,Leinster
3701,2022-04-08," 3 The Paddocks, Maryborough Hill, Douglas, Cork City ",795000,835000,-40000,-4.79,273,Cork,Munster
3703,2022-04-08," 43 Reuben Avenue, Rialto, Dublin ",505000,395000,110000,27.85,273,Dublin,Leinster
3704,2022-04-07," 11 Oak Road, Donnycarney, Dublin 9 ",325000,345000,-20000,-5.8,273,Dublin 9,Leinster
3705,2022-04-07," Apartment 106, Block F1, Louisa Park, Station Road, Leixlip, Co. Kildare ",249000,255000,-6000,-2.35,273,Kildare,Leinster
3706,2022-04-07," 44 Beechpark, Athlone, Athlone East, Westmeath ",340000,350000,-10000,-2.86,273,Westmeath,Leinster
3707,2022-04-07," Lake View,Cappanaboul,Bantry,Co Cork,P75 KR77 ",345000,369000,-24000,-6.5,273,Cork,Munster
3708,2022-04-07," Carrigrenan, Sunville, Glounthaune, Cork ",410000,395000,15000,3.8,273,Cork,Munster
3709,2022-04-07," 1 Mornington Towers, Mornington, Meath ",315000,299000,16000,5.35,273,Meath,Leinster
3710,2022-04-07," Ballylea, Dunlavin, Wicklow, W91 X8K0 ",400000,450000,-50000,-11.11,273,Wicklow,Leinster
3711,2022-04-06," Residential Development, Investment, The Grange, Kilmore Village, Co. Wexford ",450000,650000,-200000,-30.77,273,Wexford,Leinster
3712,2022-04-06," 14 Glebe View, Church Street, Finglas, Dublin ",325000,295000,30000,10.17,274,Dublin,Leinster
3713,2022-04-06," 3.8 Acres,Porterstown,Ratoath,Co Meath ",85000,70000,15000,21.43,274,Meath,Leinster
3715,2022-04-06," Rathmore House,Rathmore,Naas,County Kildare,W91Y8CX ",3685000,4150000,-465000,-11.2,274,Kildare,Leinster
3716,2022-04-06," 124 Quarry Road, Cabra, Dublin 7 ",450000,425000,25000,5.88,274,Dublin 7,Leinster
3717,2022-04-06," The Heights, Kilkee, Co. Clare ",85000,95000,-10000,-10.53,274,Clare,Munster
3718,2022-04-06," Ardrahan,Knocktown,Duncormick,Co. Wexford,Y35 D261 ",350000,375000,-25000,-6.67,274,Wexford,Leinster
3719,2022-04-05," 170 Drominbeg, Rhebogue, Limerick ",200000,195000,5000,2.56,274,Limerick,Munster
3720,2022-04-05," 4 Lough Ernie Park,Inchicullane,Killarney,Co. Kerry,V93 T2N6 ",650000,600000,50000,8.33,274,Kerry,Munster
3721,2022-04-05," 37 Kilbelin Abbey , Newbridge, Kildare ",470000,450000,20000,4.44,274,Kildare,Leinster
3723,2022-04-05," 19 Rosconnell Street, Newbridge, Kildare ",155000,165000,-10000,-6.06,275,Kildare,Leinster
3724,2022-04-05," Tullytreane,Crosskeys,Co. Cavan,H12 C446 ",150000,175000,-25000,-14.29,275,Cavan,Ulster
3725,2022-04-05," Oakwood Lodge,Ballykeane,Redcross,County Wicklow,A67AH72 ",595000,645000,-50000,-7.75,275,Wicklow,Leinster
3726,2022-04-04," 5A Market Sreet,Sligo ",60000,80000,-20000,-25.0,275,Sligo,Connaught
3727,2022-04-04," 34 Clonkeen View,Bellingham,Portlaoise,Co. Laois,R32FN73 ",255000,270000,-15000,-5.56,275,Laois,Leinster
3728,2022-04-04," 25 Ashbrook, Oranmore, Galway ",530000,550000,-20000,-3.64,275,Galway,Connaught
3729,2022-04-04," Coolgarrow, Enniscorthy, Co. Wexford ",399950,349950,50000,14.29,275,Wexford,Leinster
3730,2022-04-04," 16 Cluain Árd Court, Sea Road, Arklow, Co. Wicklow ",260000,205000,55000,26.83,275,Wicklow,Leinster
3731,2022-04-04," Ballyburn Upper,Castledermot,Co. Kildare,R14 VW02 ",325000,315000,10000,3.17,275,Kildare,Leinster
3732,2022-04-04," 601 Bridgewater, North Quay, Arklow, Wicklow ",675000,725000,-50000,-6.9,276,Wicklow,Leinster
3736,2022-04-04," 22 Birchgrove, Monaghan Road, Ballintemple, Cork ",365000,265000,100000,37.74,276,Cork,Munster
3737,2022-04-04," Lehena, Carrigadrohid, Cork ",270000,250000,20000,8.0,276,Cork,Munster
3738,2022-04-04," 93 Boyne View, Navan, Co. Meath, , Navan, Meath ",260000,265000,-5000,-1.89,276,Meath,Leinster
3739,2022-04-04," Lehenagh, Dunworley, Clonakilty, West Cork, P72 KR62 ",275000,220000,55000,25.0,276,Cork,Munster
3740,2022-04-04," The Convent House, Ballyporeen, Tipperary ",150000,175000,-25000,-14.29,276,Tipperary,Munster
3741,2022-04-04," 10 Barrowvale, Graiguecullen, Carlow ",219000,230000,-11000,-4.78,276,Carlow,Leinster
3742,2022-04-04," 17 The Courtyard, Maelduin, Dunshaughlin, Meath ",255000,245000,10000,4.08,276,Meath,Leinster
3743,2022-04-02," 27 Curragh Close, Listowel, Kerry ",175000,180000,-5000,-2.78,277,Kerry,Munster
3744,2022-04-02," 21 Curragh Close, Listowel, Kerry ",180000,185000,-5000,-2.7,277,Kerry,Munster
3746,2022-04-02," Ballinlough,Westport,Co. Mayo ",65000,85000,-20000,-23.53,277,Mayo,Connaught
3748,2022-04-01," Mt. Nebo, Gorey, Wexford ",625000,595000,30000,5.04,277,Wexford,Leinster
3749,2022-04-01," Apt 18 The Landey, Santry, Dublin 9 ",185000,195000,-10000,-5.13,277,Dublin 9,Leinster
3750,2022-04-01," Main Street, Collinstown, Westmeath ",180000,210000,-30000,-14.29,277,Westmeath,Leinster
3751,2022-04-01," 16 Windmill Court, Clonsilla, Dublin ",300000,310000,-10000,-3.23,277,Dublin,Leinster
3753,2022-04-01," 66 Curragh Finn, Kildare Town, Kildare ",275000,240000,35000,14.58,278,Kildare,Leinster
3754,2022-04-01," 35 Hapenny Bridge House, Lower Ormond Quay, Capel Street, Dublin 1 ",210000,250000,-40000,-16.0,278,Dublin 1,Leinster
3755,2022-04-01," 55 Hillcourt, Block B/C, Rathgar, Dublin 6 ",250000,270000,-20000,-7.41,278,Dublin 6,Leinster
3756,2022-04-01," 37 Rathsillan, Tullow, Carlow ",249000,239000,10000,4.18,278,Carlow,Leinster
3757,2022-04-01," Crandonnell, Barntown, Wexford ",435000,415000,20000,4.82,278,Wexford,Leinster
3758,2022-04-01," Avondale, Mitchel St, Tipperary Town, Tipperary ",345000,360000,-15000,-4.17,278,Tipperary,Munster
3760,2022-03-31," Whitestown Stables,Whitestown,Oldtown,Co. Dublin,A45 KP99 ",650000,600000,50000,8.33,278,Dublin,Leinster
3761,2022-03-31," No.12 The Rocks, Stonepark, Longford, Longford ",329000,229000,100000,43.67,278,Longford,Leinster
3762,2022-03-31," Substantial Commercial Property, Former Costcutter & Overhead Investment, 68A & 68B Malahide Road, Clontarf, Dublin 3 ",770000,725000,45000,6.21,278,Dublin 3,Leinster
3764,2022-03-31," 3 x 3.5 acres Sites SPP, Palatine, Carlow ",165000,400000,-235000,-58.75,279,Carlow,Leinster
3765,2022-03-31," Toor Newport , Newport, Tipperary ",65000,60000,5000,8.33,279,Tipperary,Munster
3767,2022-03-31," 3 Seacliff, Dunmore East, Waterford, X91 H0F6 ",249000,250000,-1000,-0.4,279,Waterford,Munster
3769,2022-03-31," 12 The Vale, Whitefield Manor, Bettystown, Meath ",275000,259000,16000,6.18,279,Meath,Leinster
3770,2022-03-31," 14 Oaktree Green, Kildare Town, Kildare ",340000,330000,10000,3.03,279,Kildare,Leinster
3771,2022-03-30," The Cottage, Glendalough, Wicklow ",1250000,1375000,-125000,-9.09,279,Wicklow,Leinster
3772,2022-03-30," Swellan Park, Swellan Lower, Cavan Town, Co. Cavan ",160000,185000,-25000,-13.51,279,Cavan,Ulster
3773,2022-03-30," Mountgordon,Castlebar,Co. Mayo,F23 CK12 ",465000,495000,-30000,-6.06,279,Mayo,Connaught
3774,2022-03-30," Somerled Lodge Riverside Greenane Rahdrum, Rathdrum, Wicklow ",286000,292500,-6500,-2.22,279,Wicklow,Leinster
3775,2022-03-30," 25 Mitchel Street, Clonmel, Co. Tipperary ",150000,180000,-30000,-16.67,279,Tipperary,Munster
3776,2022-03-30," Clarina House, Church Street, Lahinch, Clare ",490000,550000,-60000,-10.91,279,Clare,Munster
3777,2022-03-30," Killaree Gardens, Killaree, Charleville, Charleville, Cork ",239000,229000,10000,4.37,279,Cork,Munster
3778,2022-03-30," Foresters Cottage,Davidstown,Enniscorthy,Co. Wexford,Y21 X7K2 ",310000,229000,81000,35.37,279,Wexford,Leinster
3779,2022-03-30," 1 Forest Avenue, Swords, Dublin ",385000,365000,20000,5.48,280,Dublin,Leinster
3780,2022-03-30," c.2acres at Clonkeen, Lucas, Clones, Monaghan ",16000,25000,-9000,-36.0,280,Monaghan,Ulster
3781,2022-03-30," 113 Sugarloaf Crescent, Bray, Co. Wicklow ",375000,395000,-20000,-5.06,280,Wicklow,Leinster
3782,2022-03-30," 229 Olcovar, Dublin Road, Shankill, Dublin 18 ",275000,250000,25000,10.0,280,Dublin 18,Leinster
3783,2022-03-30," 34 Station Court The Avenue, Gorey, Wexford ",295000,285000,10000,3.51,280,Wexford,Leinster
3784,2022-03-30," Veronica, Douglas Lawn, Church Road, Douglas,   Cork City ",330000,350000,-20000,-5.71,280,Cork,Munster
3785,2022-03-30," 102 Glasgow Park, Limerick City, Limerick ",150000,145000,5000,3.45,280,Limerick,Munster
3786,2022-03-30," The Elms, Drinagh, Wexford Town, Wexford ",450000,400000,50000,12.5,280,Wexford,Leinster
3787,2022-03-30," Castletown,Tara,Co Meath,C15 DD56 ",575000,550000,25000,4.55,280,Meath,Leinster
3788,2022-03-29," 65 Ballinacragga,Newmarket on Fergus,Co Clare,V95 DW99 ",200000,180000,20000,11.11,280,Clare,Munster
3790,2022-03-29," 19 St. Canices Court, Finglas, Dublin 11 ",149950,169950,-20000,-11.77,280,Dublin 11,Leinster
3791,2022-03-29," Dun na Coille,Sixmilebridge,Co Clare ",125000,100000,25000,25.0,281,Clare,Munster
3792,2022-03-29," 138 Charlesland Wood, Greystones, Co. Wicklow ",465000,475000,-10000,-2.11,281,Wicklow,Leinster
3793,2022-03-29," 28 Quay Street, Balbriggan, County Dublin ",260000,315000,-55000,-17.46,281,Dublin,Leinster
3794,2022-03-29," 2 Elgin Heights, Bray, Wicklow ",399000,415000,-16000,-3.86,281,Wicklow,Leinster
3795,2022-03-29," Apartment 5  Lar Easa Court, Shore Road, Strandhill, Sligo ",225000,220000,5000,2.27,281,Sligo,Connaught
3796,2022-03-29," 24 Jocelyn Street, Dundalk, Co. Louth ",290000,330000,-40000,-12.12,281,Louth,Leinster
3797,2022-03-29," 84 Clonkeen Rd, Deansgrange, Blackrock, Dublin ",825000,750000,75000,10.0,281,Dublin,Leinster
3798,2022-03-29," 17A Belgrove Road, Clontarf,   Dublin 3 ",775000,725000,50000,6.9,281,Dublin 3,Leinster
3799,2022-03-29," 39 Whatley Hall, Clonee, Dublin 15 ",215000,230000,-15000,-6.52,281,Dublin 15,Leinster
3800,2022-03-29," 80 Hazel Park, Newcastle, Galway , Newcastle, Galway City ",350000,300000,50000,16.67,281,Galway,Connaught
3801,2022-03-29," 3 Deerpark Court, Blessington, Co. Wicklow ",234000,214000,20000,9.35,281,Wicklow,Leinster
3802,2022-03-29," 4 The Willows, Chapel Road, Bailieborough, Cavan ",249000,259000,-10000,-3.86,281,Cavan,Ulster
3803,2022-03-29," 38 Cranmer Place, off Haddington Road, Ballsbridge, Dublin 4 ",695000,650000,45000,6.92,282,Dublin 4,Leinster
3804,2022-03-29," Billypark, Cross, Mayo ",110000,135000,-25000,-18.52,282,Mayo,Connaught
3805,2022-03-28," Ardnanagh,Roscommon,Co. Roscommon,F42 EY82 ",200000,235000,-35000,-14.89,282,Roscommon,Connaught
3806,2022-03-28," Carrick, Foxford, Mayo ",180000,150000,30000,20.0,282,Mayo,Connaught
3807,2022-03-28," 52 George's Avenue, Blackrock,   County Dublin ",540000,550000,-10000,-1.82,282,Dublin,Leinster
3809,2022-03-28," 44 Abbeyfield, Balitore, Kilcullen, Co. Kildare ",220000,215000,5000,2.33,282,Kildare,Leinster
3810,2022-03-28," 4 Reuben Avenue, D08, Rialto, Dublin 8 ",425000,450000,-25000,-5.56,282,Dublin 8,Leinster
3811,2022-03-28," Austin Friar Street, Mullingar, Westmeath ",195000,175000,20000,11.43,282,Westmeath,Leinster
3812,2022-03-28," Whitepark, Dysart, Mullingar, Westmeath ",190000,175000,15000,8.57,282,Westmeath,Leinster
3813,2022-03-28," 31 Parklands Court , Ballycullen, Dublin 24 ",285000,295000,-10000,-3.39,282,Dublin 24,Leinster
3814,2022-03-28," 238 Chambers Park, Kilcock, Kildare ",225000,215000,10000,4.65,282,Kildare,Leinster
3815,2022-03-28," 15 Flanagans Terrace , Drogheda, Louth ",195000,205000,-10000,-4.88,283,Louth,Leinster
3816,2022-03-28," 37 Grange Hall, Mountmellick, Laois ",200000,185000,15000,8.11,283,Laois,Leinster
3817,2022-03-27," 1.48 Acres with F.P.P for 26 Residential Units - Rathmolyon, Co. Meath, Rathmolyon, Co. Meath, Rathmolyon, Meath ",550000,525000,25000,4.76,283,Meath,Leinster
3819,2022-03-25," Aughrismore,Cleggan,Connemara,Co.Galway ",345000,395000,-50000,-12.66,283,Galway,Connaught
3820,2022-03-25," Tinakilly Upper,Aughrim,Co. Wicklow,Y14 N978 ",399000,425000,-26000,-6.12,283,Wicklow,Leinster
3821,2022-03-25," Apartment 29 Shangan Court , Shangan Neighbourhood Centre, Ballymun, Dublin ",190000,185000,5000,2.7,283,Dublin,Leinster
3822,2022-03-25," 9 Douglas Drive, Pic Du Jer Park, Ballinlough, Cork ",310000,295000,15000,5.08,283,Cork,Munster
3823,2022-03-25," Kilmurry House,Thomastown,Co. Kilkenny,R95 F6H9 ",7500000,8800000,-1300000,-14.77,283,Kilkenny,Leinster
3824,2022-03-25," Knockalougha,Knocknagoshel,Co. Kerry,V92 HR77 ",15000,25000,-10000,-40.0,283,Kerry,Munster
3825,2022-03-25," Carrownadargney, Geevagh, Sligo ",240000,200000,40000,20.0,283,Sligo,Connaught
3826,2022-03-25," 51 Shrewsbury, Ballsbridge, Dublin 4 ",815000,825000,-10000,-1.21,283,Dublin 4,Leinster
3827,2022-03-25," Nancy Whiskeys, Haymarket, Carlow Town, Carlow ",450000,400000,50000,12.5,283,Carlow,Leinster
3828,2022-03-25," 10 Kilcross Square, Sandyford, Dublin ",335000,315000,20000,6.35,284,Dublin,Leinster
3829,2022-03-25," 3 The Cottages, Ballycoolin Rd, Blanchardstown, Dublin 15 ",395000,365000,30000,8.22,284,Dublin 15,Leinster
3830,2022-03-25," Apt.G, Coliemore Apartments, Coliemore Road, Dalkey, Dublin ",430000,450000,-20000,-4.44,284,Dublin,Leinster
3831,2022-03-24," Military Road,Buttevent,Co Cork,P51 E2R2 ",125000,150000,-25000,-16.67,284,Cork,Munster
3833,2022-03-24," Ballycumisk, Rossbrin, Ballydehob, West Cork ",550000,495000,55000,11.11,284,Cork,Munster
3834,2022-03-24," Church Street, Ballaghaderreen, Roscommon ",70000,79000,-9000,-11.39,284,Roscommon,Connaught
3837,2022-03-24," Saint Marys Road, Dundalk, Louth ",139000,145000,-6000,-4.14,284,Louth,Leinster
3838,2022-03-24," 18 St Josephs Park, Mayfield, Cork City ",245000,250000,-5000,-2.0,285,Cork,Munster
3839,2022-03-24," 5 Lady's Lane, Kilmainham, Dublin 8 ",425000,375000,50000,13.33,285,Dublin 8,Leinster
3840,2022-03-24," 16 Oakton Green, Ballybrack, Dublin ",550000,475000,75000,15.79,285,Dublin,Leinster
3841,2022-03-24," Holly Lodge, 66 Carysfort Avenue, Blackrock, Co. Dublin ",895000,925000,-30000,-3.24,285,Dublin,Leinster
3842,2022-03-23," Whitethorn Hill,Roscrea,Co Tipperary,E53 YF22 ",925000,1100000,-175000,-15.91,285,Tipperary,Munster
3843,2022-03-23," AIB Bank Building, Main Street, Ballybofey, Co. Donegal ",500000,325000,175000,53.85,285,Donegal,Ulster
3844,2022-03-23," Christianstown,Collinstown,Co. Westmeath ",99950,99500,450,0.45,285,Westmeath,Leinster
3845,2022-03-23," 17 Pierce Court, Paul Quay, Wexford, Co. Wexford ",200000,225000,-25000,-11.11,285,Wexford,Leinster
3846,2022-03-23," Moress Farm, Moress, Inch, Inch Island, Donegal ",550000,700000,-150000,-21.43,285,Donegal,Ulster
3848,2022-03-23," 10 Tulach Na Corraige, Loughrea, Co. Galway ",320000,340000,-20000,-5.88,285,Galway,Connaught
3849,2022-03-23," Main Street,Moyvane,Co. Kerry,V31 E718 ",49000,55000,-6000,-10.91,286,Kerry,Munster
3850,2022-03-23," 4 Riverview, Chapelstown Gate, Tullow Road, Carlow Town, Carlow ",200000,165000,35000,21.21,286,Carlow,Leinster
3852,2022-03-23," 2 Bridgeview, Virginia, Cavan ",225000,200000,25000,12.5,286,Cavan,Ulster
3853,2022-03-23," 104 Carrow Road, Drimnagh, Dublin 12 ",324950,349950,-25000,-7.14,286,Dublin 12,Leinster
3854,2022-03-23," Gortnahoe, Thurles, Tipperary ",100000,80000,20000,25.0,286,Tipperary,Munster
3856,2022-03-23," No. 9 Lower Bride Street, Wexford Town, Wexford ",170000,175000,-5000,-2.86,286,Wexford,Leinster
3857,2022-03-22," 8 The Pines, Grove House, Milltown Road, Milltown, Dublin 6 ",495000,525000,-30000,-5.71,286,Dublin 6,Leinster
3858,2022-03-22," Kilkieran, Kilkieran, Galway ",50000,60000,-10000,-16.67,286,Galway,Connaught
3860,2022-03-22," 18 Rialto Drive, Rialto, Dublin ",495000,345000,150000,43.48,286,Dublin,Leinster
3861,2022-03-22," 91 Boroimhe Birches, Swords, County Dublin ",370000,395000,-25000,-6.33,287,Dublin,Leinster
3862,2022-03-22," C. 0.75 Ac Site, Leamore, Blueball, Tullamore, Offaly ",26000,28000,-2000,-7.14,287,Offaly,Leinster
3863,2022-03-22," 39 Reginald Street, The Coombe, Dublin 8 ",350000,325000,25000,7.69,287,Dublin 8,Leinster
3864,2022-03-22," 5 Cearnog Brugha, Drogheda, Louth ",220000,240000,-20000,-8.33,287,Louth,Leinster
3865,2022-03-22," 72 Ballyfermot Parade, Ballyfermot, Dublin 10 ",249950,279950,-30000,-10.72,287,Dublin 10,Leinster
3867,2022-03-21," Site At Clonloghan,Newmarket on Fergus,Co Clare ",50000,60000,-10000,-16.67,287,Clare,Munster
3868,2022-03-21," Whitehill, Edgeworthstown, Longford ",55000,65000,-10000,-15.38,287,Longford,Leinster
3870,2022-03-21," Lake House,Ballaghablake,Curracloe,Co Wexford,Y21 R602 ",760000,875000,-115000,-13.14,288,Wexford,Leinster
3871,2022-03-21," 36 Millmount Grove, Windy Arbour, Dundrum, Dublin ",395000,415000,-20000,-4.82,288,Dublin,Leinster
3872,2022-03-21," 10 The Park, Athlumney Wood,, Navan, Meath ",250000,260000,-10000,-3.85,288,Meath,Leinster
3873,2022-03-20," 418 Kilmainham Square, Kilmainham, Dublin 8 ",445000,425000,20000,4.71,288,Dublin 8,Leinster
3874,2022-03-20," 5 The Oaks, Dundrum, Dublin 16 ",410000,350000,60000,17.14,288,Dublin 16,Leinster
3875,2022-03-20," 14 Upper Cross Road, Rialto, Dublin 8 ",470000,425000,45000,10.59,288,Dublin 8,Leinster
3876,2022-03-18," 68 Rathdown Road, Grangegorman, Phibsboro, Dublin 7 ",740000,730000,10000,1.37,288,Dublin 7,Leinster
3877,2022-03-18," 19 Charlestown Avenue, Finglas, Dublin 11 ",195000,210000,-15000,-7.14,288,Dublin 11,Leinster
3878,2022-03-17," Cloonagh,Sooey,Co. Sligo,F52Y278 ",85000,70000,15000,21.43,288,Sligo,Connaught
3879,2022-03-17," Verelands, Garden Vale, Athlone, County Westmeath, , Athlone East, Westmeath ",750000,825000,-75000,-9.09,288,Westmeath,Leinster
3880,2022-03-16," Suite 7 and 8, Howley`s Quay, Limerick City, Co. Limerick ",480000,450000,30000,6.67,288,Limerick,Munster
3881,2022-03-16," 42 Dunbeag,Newport Road,Castlebar,Co. Mayo. ",165000,149500,15500,10.37,288,Mayo,Connaught
3882,2022-03-16," The Point, 10 Gort Na Cladach, Carrowhubbock South,, Enniscrone, Sligo ",375000,365000,10000,2.74,288,Sligo,Connaught
3884,2022-03-16," 38 Hogan Avenue, Kileely, Co. Limerick ",85000,100000,-15000,-15.0,288,Limerick,Munster
3886,2022-03-16," Ardellis, Kilmead, Athy, Kildare ",395000,370000,25000,6.76,289,Kildare,Leinster
3887,2022-03-16," Ardellis, Kilmead, Kilcullen, Kildare ",395000,370000,25000,6.76,289,Kildare,Leinster
3888,2022-03-16," 2 Johnswood Drive, Ashbourne, Meath ",360000,370000,-10000,-2.7,289,Meath,Leinster
3889,2022-03-16," 11 Thornchase, Rush, County Dublin ",325000,295000,30000,10.17,289,Dublin,Leinster
3891,2022-03-16," 34 Cooldriona Court, Swords,   County Dublin ",199000,220000,-21000,-9.55,289,Dublin,Leinster
3894,2022-03-15," 76 Cluain Caislean, Ferns, Wexford ",189000,199000,-10000,-5.03,289,Wexford,Leinster
3895,2022-03-15," 197, Elm Mount Avenue,, Beaumont, Dublin 9 ",448000,438000,10000,2.28,290,Dublin 9,Leinster
3896,2022-03-15," 1 Hillgrove Lane, Gerald Griffin Street, Blackpool, Cork ",170000,180000,-10000,-5.56,290,Cork,Munster
3897,2022-03-15," No. 19 The Orchard, Tullaghan, Leitrim ",130000,80000,50000,62.5,290,Leitrim,Connaught
3899,2022-03-15," Canal Lodge, Greatdown, The Downs, Mullingar, Westmeath ",325000,350000,-25000,-7.14,290,Westmeath,Leinster
3903,2022-03-15," 30 Derby Lodge, Curragh, Kildare ",155000,130000,25000,19.23,290,Kildare,Leinster
3904,2022-03-15," 23 Bracklin Park, Edgeworthstown, Longford ",145000,140000,5000,3.57,290,Longford,Leinster
3905,2022-03-15," Cottage at Grange Sylvae, Gowran, Kilkenny ",127000,120000,7000,5.83,290,Kilkenny,Leinster
3906,2022-03-15," 340 Mourne Road, Drimnagh, Dublin 12 ",435000,375000,60000,16.0,290,Dublin 12,Leinster
3907,2022-03-15," 2 Slaneyside Court, Church Lane, Baltinglass, Wicklow ",159000,150000,9000,6.0,290,Wicklow,Leinster
3908,2022-03-15," 24 Cluain Craoibh, Kinnegad, Westmeath ",235000,230000,5000,2.17,290,Westmeath,Leinster
3909,2022-03-14," Unit At Kilrush Business Park,Kilrush,Dungarvan,Co. Waterford,X35 R920 ",285000,250000,35000,14.0,290,Waterford,Munster
3910,2022-03-14," Kilgainey, Clonmel, Co. Tipperary ",40000,50000,-10000,-20.0,291,Tipperary,Munster
3911,2022-03-14," 12 Kingsmill Court, North City Centre, Dublin 1 ",270000,260000,10000,3.85,291,Dublin 1,Leinster
3912,2022-03-14," Kilgobbin,Ballinadee,Co. Cork,P72 T028 ",380000,400000,-20000,-5.0,291,Cork,Munster
3913,2022-03-14," Robin Hill, Ardagh, Clifden, Galway ",495000,575000,-80000,-13.91,291,Galway,Connaught
3915,2022-03-14," 11 Ardee Road, Dunleer, Co. Louth ",120000,125000,-5000,-4.0,291,Louth,Leinster
3916,2022-03-14," Apt19 House 2, Linden Court, Grove Avenue, Blackrock, Co. Dublin ",750000,700000,50000,7.14,291,Dublin,Leinster
3917,2022-03-14," Main Street, Kilnaleck, Co. Cavan ",195000,175000,20000,11.43,291,Cavan,Ulster
3918,2022-03-14," 98 Tandy Park, Betram Court, Dublin City Centre, Dublin 8, Dublin ",240000,250000,-10000,-4.0,291,Dublin 8,Leinster
3920,2022-03-14," 33 Robswall Crescent, Malahide, Dublin ",875000,785000,90000,11.47,291,Dublin,Leinster
3921,2022-03-14," Verelands,Garden Vale,Athlone,County Westmeath,N37Y0Y5 ",750000,825000,-75000,-9.09,291,Westmeath,Leinster
3922,2022-03-12," Main St, Newtowngore, Leitrim ",149500,155000,-5500,-3.55,291,Leitrim,Connaught
3923,2022-03-11," Oakdeane,Killyon Hill,Bonavalley,Co. Westmeath,N37 TC03 ",395000,425000,-30000,-7.06,292,Westmeath,Leinster
3924,2022-03-11," 87 Coney Meadows,Coneyboro,Athy,Co Kildare,R14 A521 ",175000,168000,7000,4.17,292,Kildare,Leinster
3925,2022-03-11," 66 Chestnut Grove, Castlebar, Mayo ",175000,140000,35000,25.0,292,Mayo,Connaught
3927,2022-03-11," 38 The Crescent Meadowvale, Arklow, Wicklow ",329000,325000,4000,1.23,292,Wicklow,Leinster
3931,2022-03-11," 27 Bessborough Avenue, D03, North Strand, Dublin 3 ",375000,385000,-10000,-2.6,292,Dublin 3,Leinster
3933,2022-03-11," 50 Bunting Road, Walkinstown, Dublin 12 ",349950,374950,-25000,-6.67,292,Dublin 12,Leinster
3934,2022-03-11," 92 Castlegate, Portarlington, Laois ",299950,310000,-10050,-3.24,293,Laois,Leinster
3937,2022-03-10," 19 Sycamore Crescent, The Park, Cabinteely, Cabinteely, Dublin 18 ",545000,525000,20000,3.81,293,Dublin 18,Leinster
3938,2022-03-10," 78 Rahoonane, Tralee, Kerry ",135000,120000,15000,12.5,293,Kerry,Munster
3939,2022-03-10," 6 Canalside,Athy,Co. Kildare,R14 YK58 ",119950,95000,24950,26.26,293,Kildare,Leinster
3941,2022-03-10," 46 De Lacy Court,Trim,Co Meath,C15 V320 ",365000,380000,-15000,-3.95,294,Meath,Leinster
3942,2022-03-09," The Old School view, The Piers, Walterstown, Cobh, Cork ",530000,550000,-20000,-3.64,294,Cork,Munster
3943,2022-03-09," 12.6 Acres, Dunkitt, Kilmacow, Co. Kilkenny ",130000,150000,-20000,-13.33,294,Kilkenny,Leinster
3944,2022-03-09," Gneeves,Glantane,Lombardstown,Co. Cork. ",30000,50000,-20000,-40.0,294,Cork,Munster
3945,2022-03-09," 3 Hayworth Terrace, Ongar, Dublin 15 ",310000,280000,30000,10.71,294,Dublin 15,Leinster
3946,2022-03-09," 35 Adare Avenue, Coolock, Coolock,   Dublin 17 ",320000,299000,21000,7.02,294,Dublin 17,Leinster
3948,2022-03-09," Three Bed Semi-Detached Residence, 73 Burgage Manor, Blessington, Wicklow ",385000,369000,16000,4.34,294,Wicklow,Leinster
3949,2022-03-09," 55 Barons Hall Park,Balbriggan,Co. Dublin,K32 R207 ",189950,199950,-10000,-5.0,294,Dublin,Leinster
3950,2022-03-09," Glanaderig,Rathea,Listowel,Co. Kerry,V31 CY28 ",130000,120000,10000,8.33,294,Kerry,Munster
3951,2022-03-09," Trimbleston, Goatstown, Dublin 14 ",465000,595000,-130000,-21.85,295,Dublin 14,Leinster
3952,2022-03-09," 5 Willow Place, Athlone East, Westmeath ",195000,185000,10000,5.41,295,Westmeath,Leinster
3953,2022-03-09," Riverside Business Park, Tinahely, Wicklow ",65000,75000,-10000,-13.33,295,Wicklow,Leinster
3954,2022-03-09," Quarry Road, Youghal, Cork ",450000,550000,-100000,-18.18,295,Cork,Munster
3955,2022-03-09," Thornhill, Kinvara, Galway ",220000,230000,-10000,-4.35,295,Galway,Connaught
3956,2022-03-09," 153 Kiltipper Gate, Tallaght,   Dublin 24 ",199950,224950,-25000,-11.11,295,Dublin 24,Leinster
3957,2022-03-08," San-Antonio, Knocknaboha, Cahir, Co. Tipperary ",285000,265000,20000,7.55,295,Tipperary,Munster
3958,2022-03-08," 87 The Casino, Malahide, Dublin ",795000,800000,-5000,-0.63,295,Dublin,Leinster
3959,2022-03-08," 374 Kildare Road, Drimnagh,   Dublin 12 ",274950,299950,-25000,-8.33,295,Dublin 12,Leinster
3960,2022-03-08," Apt 66 The Dock Mill, Barrow Street, Dublin 4, Dublin ",399950,429950,-30000,-6.98,295,Dublin 4,Leinster
3961,2022-03-08," 18 Father Redmond Park, Arklow, Wicklow ",255000,239000,16000,6.69,295,Wicklow,Leinster
3962,2022-03-08," 12 Forgehill Rise, Stamullen, Meath ",285000,290000,-5000,-1.72,295,Meath,Leinster
3965,2022-03-07," Cloonshaghan,Croghan,Co. Roscommon,F52NF82 ",355000,375000,-20000,-5.33,296,Roscommon,Connaught
3966,2022-03-07," 24 Central Avenue, Parnell Park, A91, Dundalk, Co. Louth ",135000,129000,6000,4.65,296,Louth,Leinster
3967,2022-03-07," Development Site (FPP for 5 Houses),Lackagh,Mountrice,Monasterevin,Co. Kildare ",350000,450000,-100000,-22.22,296,Kildare,Leinster
3968,2022-03-07," Kye, Elphin, Co. Roscommon ",155000,139000,16000,11.51,296,Roscommon,Connaught
3969,2022-03-07," Unit 2 Town Parks, Leitrim Road, Carrick on Shannon, Co Leitrim N41 D6V9 ",230000,200000,30000,15.0,296,Leitrim,Connaught
3971,2022-03-07," Ardeevin, Clonattin Road, Gorey, Wexford ",290000,330000,-40000,-12.12,296,Wexford,Leinster
3972,2022-03-07," Cromane Upper, Killorglin, Cromane, Kerry ",165000,160000,5000,3.13,296,Kerry,Munster
3973,2022-03-07," 29 Chambersland Close , New Ross, Wexford ",185000,175000,10000,5.71,296,Wexford,Leinster
3974,2022-03-07," 2 Castle Cove, , Killorglin, Kerry ",290000,300000,-10000,-3.33,296,Kerry,Munster
3975,2022-03-07," Pier Road, Enniscrone, Sligo ",400000,395000,5000,1.27,296,Sligo,Connaught
3976,2022-03-07," Brown's Lane, Two Mile House , Naas, Kildare ",940000,925000,15000,1.62,296,Kildare,Leinster
3977,2022-03-07," Marion Terrace, Ballinakill, Dunmore Road, Waterford ",140000,125000,15000,12.0,297,Waterford,Munster
3978,2022-03-07," Connagh, Fethard, Wexford ",399500,420000,-20500,-4.88,297,Wexford,Leinster
3979,2022-03-07," 55 Slaney Bank, Rathvilly, Carlow ",240000,235000,5000,2.13,297,Carlow,Leinster
3980,2022-03-07," 6 Brock Hall, Brocks Lane, Dun Laoghaire, County Dublin ",320000,330000,-10000,-3.03,297,Dublin,Leinster
3981,2022-03-07," 43, Chapel Farm Avenue, Lusk, Dublin ",265000,235000,30000,12.77,297,Dublin,Leinster
3982,2022-03-07," 15 Beechurst, Killarney Road, Bray, Wicklow ",695000,725000,-30000,-4.14,297,Wicklow,Leinster
3983,2022-03-07," Apartment 26, The Sycamore, Trimbleston, Goatstown, Dublin 14 ",435000,480000,-45000,-9.38,297,Dublin 14,Leinster
3984,2022-03-06," 26 St. James Court, Kilmainham, Dublin 8 ",320000,275000,45000,16.36,297,Dublin 8,Leinster
3985,2022-03-05," 65 Hannah Square, Lucan, County Dublin ",290000,250000,40000,16.0,297,Dublin,Leinster
3986,2022-03-04," Railway Cottage,Eastlone,Camus Road,Cashel,Co. Tipperary ",225000,195000,30000,15.38,297,Tipperary,Munster
3987,2022-03-04," Claremount,Claremorris,Co Mayo,F12XY72 ",369000,325000,44000,13.54,297,Mayo,Connaught
3988,2022-03-04," 42 Stapolin Lawns, Baldoyle, Dublin 13 ",495000,485000,10000,2.06,297,Dublin 13,Leinster
3989,2022-03-04," Residential Farm at Prughlish, Keshcarrigan, Leitrim ",295000,275000,20000,7.27,297,Leitrim,Connaught
3990,2022-03-04," Bleach, Villierstown, Co. Waterford ",70000,68500,1500,2.19,297,Waterford,Munster
3991,2022-03-04," Dunsallagh West,Miltown Malbay,Co Clare,V95 W0F2 ",250000,285000,-35000,-12.28,297,Clare,Munster
3992,2022-03-04," Ardcloon,Straide,Foxford,Co Mayo,F26PH34 ",79000,95000,-16000,-16.84,297,Mayo,Connaught
3993,2022-03-04," Watergate Street, Kanturk, Cork ",180000,250000,-70000,-28.0,298,Cork,Munster
3994,2022-03-04," Curtin's Lane, Market street, Ennis, Clare ",350000,375000,-25000,-6.67,298,Clare,Munster
3995,2022-03-04," 12 Westpoint Business Park, Y35, Wexford, Co. Wexford ",220000,250000,-30000,-12.0,298,Wexford,Leinster
3996,2022-03-04," 27 Macregol Cuirt, Seffin, Birr, Offaly ",120000,110000,10000,9.09,298,Offaly,Leinster
3997,2022-03-04," 7 Rothe Abbey Court, Kilmainham, Dublin 8 ",390000,325000,65000,20.0,298,Dublin 8,Leinster
3998,2022-03-04," 77 Bow Bridge Place, Kilmainham, Dublin 8 ",245000,200000,45000,22.5,298,Dublin 8,Leinster
3999,2022-03-03," 16 Belgrove Park, Chapelizod, Dublin 20 ",715000,725000,-10000,-1.38,298,Dublin 20,Leinster
4000,2022-03-03," Prime Commercial Site,Derrybeg,Donegal ",130000,180000,-50000,-27.78,298,Donegal,Ulster
4001,2022-03-03," 41, Birchwood Drive, Springfield, Tallaght, Dublin 24 ",325000,280000,45000,16.07,298,Dublin 24,Leinster
4002,2022-03-03," 1 Lioscian, Swords, County Dublin ",380000,1000000,-620000,-62.0,298,Dublin,Leinster
4003,2022-03-03," 41A Dodsborough Cottages, Shackelton Way, Lucan, Dublin ",525000,499950,25050,5.01,298,Dublin,Leinster
4004,2022-03-03," Meenoline,Templeglantine,Co Limerick ",110000,105000,5000,4.76,298,Limerick,Munster
4005,2022-03-03," Glen View House, Boola, Lackaroe, Youghal, East Cork ",185000,155000,30000,19.35,299,Cork,Munster
4006,2022-03-03," 36 Abbeywood Court, Lucan, Dublin ",360000,348000,12000,3.45,299,Dublin,Leinster
4007,2022-03-03," 1 Mountmahon, Abbeyfeale, Limerick ",195000,200000,-5000,-2.5,299,Limerick,Munster
4008,2022-03-02," 14 Hunters Way, Maryborough Woods, Douglas, Cork City ",425000,395000,30000,7.59,299,Cork,Munster
4009,2022-03-02," 13 Clonattin Village, Gorey, Wexford ",295000,270000,25000,9.26,299,Wexford,Leinster
4010,2022-03-02," 46 Ha'Penny Bridge House, Ormond Quay Lower, North City Centre, Dublin 1 ",335000,350000,-15000,-4.29,299,Dublin 1,Leinster
4011,2022-03-02," 42 Cois na hAbhainn, Nurney, Kildare Town, Kildare ",365000,350000,15000,4.29,299,Kildare,Leinster
4013,2022-03-02," 23 Rialto Cottages, Rialto, Dublin 8 ",275000,295000,-20000,-6.78,299,Dublin 8,Leinster
4014,2022-03-02," Aideen Place, Terenure, Dublin 6W ",759950,775000,-15050,-1.94,299,Dublin,Leinster
4015,2022-03-02," 45 The Water Rill, Waterside,, Malahide, Dublin ",270000,275000,-5000,-1.82,299,Dublin,Leinster
4018,2022-03-02," Lackagh, Castleblayney, Monaghan ",310000,300000,10000,3.33,300,Monaghan,Ulster
4019,2022-03-02," 43 Westfield Road, Harold's Cross, Dublin 6W ",750000,640000,110000,17.19,300,Dublin,Leinster
4021,2022-03-01," ""The Wood"" Killaveny,, Tinahely, Wicklow ",349000,329000,20000,6.08,300,Wicklow,Leinster
4022,2022-03-01," 16 Sweetfield Estate, Youghal, East Cork ",295000,330000,-35000,-10.61,300,Cork,Munster
4023,2022-03-01," 8 Riverchapel Bank, Gorey, Wexford ",149000,150000,-1000,-0.67,300,Wexford,Leinster
4024,2022-03-01," 21 Strawberry Hill, Bunclody, Co. Wexford , Bunclody, Wexford ",179000,190000,-11000,-5.79,300,Wexford,Leinster
4025,2022-03-01," 39 Saint Canice's Square, Finglas, Dublin 11 ",235000,200000,35000,17.5,300,Dublin 11,Leinster
4026,2022-03-01," 9 Glenn Ard, Dunmore East, Waterford ",350000,295000,55000,18.64,300,Waterford,Munster
4027,2022-03-01," 24 Seaview, Kilcoole, Wicklow ",395000,435000,-40000,-9.2,300,Wicklow,Leinster
4028,2022-03-01," 59A Inchicore Road, Inchicore, Dublin 8 ",1050000,1200000,-150000,-12.5,300,Dublin 8,Leinster
4029,2022-03-01," 81 Sandhills,Hacketstown Road,Carlow,R93 W9A2 ",295000,280000,15000,5.36,300,Carlow,Leinster
4031,2022-03-01," Apartment 7 32-33 Gardiner Street Upper, North City Centre, Dublin ",225000,215000,10000,4.65,300,Dublin,Leinster
4032,2022-03-01," No,1118 Kilkee Bay Apartments Kilrush Road , Kilkee, Clare ",185000,175000,10000,5.71,301,Clare,Munster
4033,2022-03-01," Penthouse Apartment 40a, Inver Geal, Carrick-on-Shannon, Roscommon ",199000,220000,-21000,-9.55,301,Roscommon,Connaught
4034,2022-03-01," 10 Lios Na Sioga, Binghamstown, Belmullet, Mayo ",135000,110000,25000,22.73,301,Mayo,Connaught
4035,2022-03-01," Ballinroe, Templetuohy, Thurles, Tipperary ",235000,195000,40000,20.51,301,Tipperary,Munster
4036,2022-03-01," 8 Chapel Street, Ballymore Eustace, Kildare ",119000,135000,-16000,-11.85,301,Kildare,Leinster
4039,2022-03-01," 64 MERRION VILLAGE, Ballsbridge, Dublin 4 ",395000,400000,-5000,-1.25,301,Dublin 4,Leinster
4040,2022-03-01," Keenagh, Ballyjamesduff, Co Cavan A82DH99 ",95000,70000,25000,35.71,301,Cavan,Ulster
4041,2022-02-28," Derrinkeher, Aughnasheelin, Ballinamore, Co. Leitrim ",125000,119900,5100,4.25,301,Leitrim,Connaught
4042,2022-02-28," Dublin Road, Rahardrum, A82, Virginia, Co. Cavan ",285000,295000,-10000,-3.39,301,Cavan,Ulster
4043,2022-02-28," 23, Seaview, Kilcoole, Kilcoole, Wicklow ",375000,385000,-10000,-2.6,301,Wicklow,Leinster
4044,2022-02-28," 4 Woodford Lawn, Clondalkin, Dublin 22 ",317000,295000,22000,7.46,301,Dublin 22,Leinster
4045,2022-02-28," Glen View, Cliggin, Doon, Co. Limerick ",215000,230000,-15000,-6.52,301,Limerick,Munster
4047,2022-02-28," 120 Millbrook, Johnstown, Navan, Co. Meath, Johnstown, Meath ",267500,250000,17500,7.0,302,Meath,Leinster
4048,2022-02-28," 192 Seven Oaks, Inchicore, Dublin 8 ",320000,275000,45000,16.36,302,Dublin 8,Leinster
4049,2022-02-28," Beaghmagheross, Carrickmacross, Monaghan ",50000,75000,-25000,-33.33,302,Monaghan,Ulster
4050,2022-02-28," 65 The Atrium, Roebuck Hill, Clonskeagh, Dublin 14 ",364000,355000,9000,2.54,302,Dublin 14,Leinster
4052,2022-02-25," ""Teach na Feile"" Crannagh, Summerhill, Athlone, ., Co. Roscommon ",375000,395000,-20000,-5.06,302,Roscommon,Connaught
4053,2022-02-25," 3 The Lake District,Aghadoe,Killarney,Co. Kerry ",425000,385000,40000,10.39,302,Kerry,Munster
4054,2022-02-25," Side of 37, Old Hayestown, Rush, County Dublin ",330000,350000,-20000,-5.71,302,Dublin,Leinster
4055,2022-02-25," Kincon, Ballina, Mayo, F26H2T7 ",340000,250000,90000,36.0,302,Mayo,Connaught
4056,2022-02-25," 14 Marian Hill, Portarlington, Laois ",160000,170000,-10000,-5.88,302,Laois,Leinster
4058,2022-02-25," 105 Comerfords Cross, Woodford Lane, Portmarnock, Dublin ",530000,520000,10000,1.92,302,Dublin,Leinster
4060,2022-02-25," Glengad, Pollathomas, Ballina, Mayo ",45000,75000,-30000,-40.0,303,Mayo,Connaught
4061,2022-02-24," Glen of the Downs, Delgany,, Glen Of The Downs, Wicklow ",100000,90000,10000,11.11,303,Wicklow,Leinster
4062,2022-02-24," 7 Straffan Gate, Straffan, Co. Kildare ",495000,525000,-30000,-5.71,303,Kildare,Leinster
4063,2022-02-24," 91A Jamestown Avenue, Inchicore, Dublin 8 ",475000,395000,80000,20.25,303,Dublin 8,Leinster
4064,2022-02-24," Rosies Cottage, Drumrora, A82, Ballyjamesduff, Co. Cavan ",195000,220000,-25000,-11.36,303,Cavan,Ulster
4068,2022-02-24," 2 Leinster Crescent, Old Dublin Road, Carlow Town, Co. Carlow ",435000,475000,-40000,-8.42,303,Carlow,Leinster
4069,2022-02-24," 13 Mount Eustace Crescent, Tyrrelstown, Dublin 15 ",325000,390000,-65000,-16.67,303,Dublin 15,Leinster
4070,2022-02-24," 20 Myra Manor, Malahide, Dublin ",1435000,1575000,-140000,-8.89,303,Dublin,Leinster
4071,2022-02-24," 10 Highfield Manor, Graiguecullen, Co. Carlow ",225000,219500,5500,2.51,303,Carlow,Leinster
4073,2022-02-24," Apartment 12 Stocking Wood Copse, Stocking Avenue, Rathfarnham, Dublin ",299000,315000,-16000,-5.08,304,Dublin,Leinster
4074,2022-02-23," Ballyrea,Wells,Gorey,Co. Wexford,Y25CF59 ",200000,185000,15000,8.11,304,Wexford,Leinster
4076,2022-02-23," 3 Carysfort Park, Blackrock, County Dublin ",745000,795000,-50000,-6.29,304,Dublin,Leinster
4077,2022-02-23," 18, Copley Hall, Cotters Street, City Centre Sth, Cork City ",265000,275000,-10000,-3.64,304,Cork,Munster
4079,2022-02-23," Ballintubber,Carrigtwohill,Co Cork,T45 DH27 ",730000,650000,80000,12.31,305,Cork,Munster
4080,2022-02-22," Apartment 183, Block 4, Parklands, Santry, Dublin 9 ",280000,275000,5000,1.82,305,Dublin 9,Leinster
4081,2022-02-22," 56 Mount Drummond Square, Harold's Cross, Dublin 6W ",430000,375000,55000,14.67,305,Dublin,Leinster
4082,2022-02-22," Riverdell, 405 Haymarket, Co. Carlow ",189950,149950,40000,26.68,305,Carlow,Leinster
4083,2022-02-22," 196 Marian Park, Drogheda, Louth ",170000,180000,-10000,-5.56,305,Louth,Leinster
4084,2022-02-22," Main Street, Aughrim, Wicklow ",160000,180000,-20000,-11.11,305,Wicklow,Leinster
4085,2022-02-22," Bayleek,Lower Sky Road,Clifden,Co.Galway ",280000,325000,-45000,-13.85,305,Galway,Connaught
4086,2022-02-22," 56 Borris Little, Portlaoise, Laois ",199000,210000,-11000,-5.24,305,Laois,Leinster
4087,2022-02-22," 70 Mayeston Square, Finglas, Dublin 11 ",225000,214950,10050,4.68,305,Dublin 11,Leinster
4088,2022-02-22," Westpoint Business Park, Y35, Wexford, Co. Wexford ",150000,140000,10000,7.14,305,Wexford,Leinster
4089,2022-02-22," 35 Kilkea House, Clare Village, Clarehall, Dublin 13 ",270000,265000,5000,1.89,305,Dublin 13,Leinster
4090,2022-02-22," Ballyviniter Lower, Mallow, Cork ",450000,425000,25000,5.88,305,Cork,Munster
4091,2022-02-22," 74 Bantry Square, Blanchardstown, Dublin 15 ",330000,350000,-20000,-5.71,305,Dublin 15,Leinster
4092,2022-02-21," Clonbalt House,Cloonbalt,Longford,N39A2C1 ",265000,275000,-10000,-3.64,305,Longford,Leinster
4093,2022-02-21," .54 Acre Site,Bohercuill,Belclare,Tuam,Co. Galway ",30000,40000,-10000,-25.0,306,Galway,Connaught
4094,2022-02-21," Carrickgorman, Co.Cavan, Bailieborough, Co. Cavan ",99000,130000,-31000,-23.85,306,Cavan,Ulster
4095,2022-02-21," 31 Seven Oaks, Inchicore, Dublin 8 ",370000,275000,95000,34.55,306,Dublin 8,Leinster
4096,2022-02-21," Clogheen Road, Clonakilty, West Cork ",250000,210000,40000,19.05,306,Cork,Munster
4097,2022-02-21," Newtown House On 12 Acres,Newtownpilsworth,Maganey,Co Kildare,R93 F9P5 ",595000,625000,-30000,-4.8,306,Kildare,Leinster
4098,2022-02-21," Station Road, Castlebellingham, Louth ",225000,195000,30000,15.38,306,Louth,Leinster
4099,2022-02-21," 71 Slievekeale, Waterford City, Waterford ",145000,140000,5000,3.57,306,Waterford,Munster
4100,2022-02-21," 24 The Green, Ayrfield, Granges Road, Kilkenny ",595000,590000,5000,0.85,306,Kilkenny,Leinster
4101,2022-02-20," Castle Heights,Kilmoney Road,Carrigaline,Co Cork,P43 A362 ",335000,330000,5000,1.52,306,Cork,Munster
4104,2022-02-18," 4 Wilton Park Villas, Bishopstown Road, Bishopstown, Cork ",240000,245000,-5000,-2.04,307,Cork,Munster
4105,2022-02-18," No. 15 Church Street, Gorey, Wexford ",175000,200000,-25000,-12.5,307,Wexford,Leinster
4106,2022-02-18," 22 Ard Aoibhinn, Monivea, Galway ",220000,200000,20000,10.0,307,Galway,Connaught
4109,2022-02-17," 47 St. James Court, Kilmainham, Dublin 8 ",355000,295000,60000,20.34,307,Dublin 8,Leinster
4110,2022-02-17," 118 Upper Dorset Street, Dorset Street, Dublin 1 ",550000,600000,-50000,-8.33,308,Dublin 1,Leinster
4113,2022-02-17," Glenhouse, Kilmeaden, Co. Waterford, Kilmeaden, Waterford ",575000,595000,-20000,-3.36,308,Waterford,Munster
4114,2022-02-17," 4 St. Johns Park South, Johnstown, Naas, Co. Kildare ",850000,775000,75000,9.68,308,Kildare,Leinster
4115,2022-02-16," 14 Tara Court, Ashbourne, Meath, A84R251 ",240000,220000,20000,9.09,308,Meath,Leinster
4117,2022-02-16," 31 The Close, Clonattin Village , Gorey, Wexford ",249500,276500,-27000,-9.76,308,Wexford,Leinster
4118,2022-02-16," 34 Churchview, Claregalway, Galway ",300000,278000,22000,7.91,309,Galway,Connaught
4119,2022-02-16," 1C Old Hayestown, Rush, County Dublin ",549000,499950,49050,9.81,309,Dublin,Leinster
4120,2022-02-16," 10 Birchwood Close, Onslow Gardens, Blackpool, Cork ",275000,245000,30000,12.24,309,Cork,Munster
4121,2022-02-16," 'The Cottage', Silloge, Monasterboice, Drogheda, Louth ",210000,200000,10000,5.0,309,Louth,Leinster
4122,2022-02-15," 24 Village Square,Glaslough,Co. Monaghan,H18CY83 ",285000,270000,15000,5.56,309,Monaghan,Ulster
4123,2022-02-15," 34 Belville, Donnybrook, Dublin 4 ",345000,340000,5000,1.47,309,Dublin 4,Leinster
4124,2022-02-15," 14 Grange Road, New Ross, Wexford ",227500,230000,-2500,-1.09,309,Wexford,Leinster
4126,2022-02-15," Derelict Residence on C. 1.29 Acre Site at Ballydaly Cross, Ballydaly, Tullamore, Offaly ",150000,175000,-25000,-14.29,310,Offaly,Leinster
4127,2022-02-15," 25 Shanacloon, Shanballa, Ennis, Clare ",160000,150000,10000,6.67,310,Clare,Munster
4128,2022-02-15," 11, Greenane Cottages, Greenane, Kanturk, Cork ",110000,80000,30000,37.5,310,Cork,Munster
4129,2022-02-15," "" Creteboom "" Quay Road, Ballina, Mayo ",395000,330000,65000,19.7,310,Mayo,Connaught
4130,2022-02-14," Carnalough, Doocastle, Co. Mayo ",169000,160000,9000,5.63,310,Mayo,Connaught
4131,2022-02-14," 104 The Briars, Ashbourne, Meath ",460000,425000,35000,8.24,310,Meath,Leinster
4132,2022-02-14," 16 Harbour Cottage, Dundalk, Carlingford, Co. Louth ",340000,315000,25000,7.94,310,Louth,Leinster
4133,2022-02-14," 24A Pembroke Grove, Pembroke Wood, Passage West, Cork ",265000,235000,30000,12.77,310,Cork,Munster
4134,2022-02-14," 52 The Green, College Road, Galway City, Co. Galway ",420000,440000,-20000,-4.55,310,Galway,Connaught
4135,2022-02-14," 17 Reilly's Avenue, South City Centre - D8, Dublin 8 ",330000,345000,-15000,-4.35,311,Dublin 8,Leinster
4136,2022-02-14," St Catherines, North Strand, Drogheda, Louth ",150000,115000,35000,30.43,311,Louth,Leinster
4137,2022-02-13," 59 Seamount, Stillorgan, Stillorgan, County Dublin ",535000,550000,-15000,-2.73,311,Dublin,Leinster
4139,2022-02-11," 12 The Moorings,Ballina,Co Mayo,F26 X3D6 ",330000,350000,-20000,-5.71,311,Mayo,Connaught
4141,2022-02-11," 182 Athlumney Castle,Navan,Co. Meath,C15 H3K1 ",395000,325000,70000,21.54,311,Meath,Leinster
4144,2022-02-11," 1c, Old Hayestown, Rush, County Dublin ",549000,499950,49050,9.81,311,Dublin,Leinster
4146,2022-02-11," Highfield, Clonleight, New Ross, Wexford ",355000,350000,5000,1.43,311,Wexford,Leinster
4150,2022-02-11," Site at No. 2 Monaloe Crescent, Blackrock, County Dublin ",395000,390000,5000,1.28,312,Dublin,Leinster
4151,2022-02-11," 3 Thomond Road, Thurles, Tipperary ",180000,150000,30000,20.0,312,Tipperary,Munster
4152,2022-02-11," No. 2 Monaloe Crescent, Blackrock, County Dublin ",795000,790000,5000,0.63,312,Dublin,Leinster
4153,2022-02-11," Vico, The Victorian Villa, The Court Killiney Bay, Killiney, County Dublin ",1150000,1250000,-100000,-8.0,312,Dublin,Leinster
4154,2022-02-11," No 40 Eire Street, Gorey, Wexford ",175000,165000,10000,6.06,312,Wexford,Leinster
4155,2022-02-10," Cooley Lodge, Peterswell, Gort, Galway ",195000,200000,-5000,-2.5,312,Galway,Connaught
4156,2022-02-10," (SITE WITH FULL P.P) 190A IVERAGH ROAD, Whitehall, Dublin 9 ",225000,250000,-25000,-10.0,312,Dublin 9,Leinster
4157,2022-02-10," 17 Ashville Close, Lucan, Dublin ",490000,475000,15000,3.16,312,Dublin,Leinster
4158,2022-02-10," Glenidan, Collinstown, Westmeath ",244950,237500,7450,3.14,312,Westmeath,Leinster
4159,2022-02-10," 4 Red Abbey Court, Margaret Street, Cork City, Cork ",340000,295000,45000,15.25,312,Cork,Munster
4160,2022-02-10," 3 Estuary Walk, Malahide, Dublin ",495000,475000,20000,4.21,312,Dublin,Leinster
4162,2022-02-10," 9 Alderpark Court, Tallaght, Dublin 24 ",245000,195000,50000,25.64,312,Dublin 24,Leinster
4164,2022-02-10," Carrick Road, Mullinahone, Tipperary ",26000,29000,-3000,-10.34,312,Tipperary,Munster
4165,2022-02-10," Stradbally North, Castleconnell, Limerick ",100000,75000,25000,33.33,313,Limerick,Munster
4166,2022-02-10," 53 Liffey Terrace, Liffey Valley Park, Lucan, Dublin ",335000,325000,10000,3.08,313,Dublin,Leinster
4167,2022-02-10," 5 Moodogue Lane, Oldcastle Road, Ballyjamesduff, Co. Cavan ",165000,145000,20000,13.79,313,Cavan,Ulster
4173,2022-02-09," Kilbrin, Mallow, Cork ",220000,275000,-55000,-20.0,313,Cork,Munster
4174,2022-02-09," 45A The Metropolitan, Kilmainham, Dublin 8 ",285000,245000,40000,16.33,313,Dublin 8,Leinster
4176,2022-02-09," 1 St Mary's Road, Howth, County Dublin ",299500,350000,-50500,-14.43,313,Dublin,Leinster
4177,2022-02-09," 4 Swallowbrook Park, Littlepace, Clonee, Dublin 15 ",475000,449950,25050,5.57,313,Dublin 15,Leinster
4178,2022-02-09," Apt 40 Ballintyre Square, Ballinteer, Dublin 16 ",365000,360000,5000,1.39,313,Dublin 16,Leinster
4182,2022-02-08," Garage & Showroom,Galway Road,Athleague,Co. Roscommon ",300000,400000,-100000,-25.0,314,Roscommon,Connaught
4183,2022-02-08," 18 Foster Terrace, Drumcondra, Dublin 3 ",349000,355000,-6000,-1.69,314,Dublin 3,Leinster
4184,2022-02-08," 116 Tubberclaire Meadows, Navan, Meath ",285000,280000,5000,1.79,314,Meath,Leinster
4185,2022-02-08," Apartment 2, Cluain Mhuire, Upper Glenageary Rd, Glenageary, County Dublin ",325000,250000,75000,30.0,314,Dublin,Leinster
4187,2022-02-08," Crushoa, Kinvara, Galway ",675000,650000,25000,3.85,315,Galway,Connaught
4188,2022-02-08," 62 Pembroke Cottages , Donnybrook, Dublin 4 ",590000,595000,-5000,-0.84,315,Dublin 4,Leinster
4190,2022-02-08," Churchview, Cuffesgrange, Kilkenny ",570000,535000,35000,6.54,315,Kilkenny,Leinster
4191,2022-02-07," Lismoyne, North Circular Road, Co. Limerick ",375000,365000,10000,2.74,315,Limerick,Munster
4194,2022-02-07," 4 The Mews, 41 North Great Georges Street, North City Centre, Dublin 1 ",230000,185000,45000,24.32,315,Dublin 1,Leinster
4196,2022-02-07," 1 Millpark Road,Enniscorthy,Co. Wexford,Y21V9T0 ",180000,169000,11000,6.51,315,Wexford,Leinster
4197,2022-02-07," Council Depo, Birdhill, Co. Tipperary ",75000,50000,25000,50.0,315,Tipperary,Munster
4199,2022-02-07," Ashfield, Cootehill, Cavan ",895000,800000,95000,11.88,316,Cavan,Ulster
4200,2022-02-07," Laravoolta,Enniskeane,Co. Cork ",35000,45000,-10000,-22.22,316,Cork,Munster
4201,2022-02-07," Lands at Smithstown, Julianstown, Meath ",800000,786000,14000,1.78,316,Meath,Leinster
4204,2022-02-07," 63 Ormond Street, Nenagh, Tipperary ",152500,149500,3000,2.01,316,Tipperary,Munster
4205,2022-02-07," Killachonna, Mount Temple, Moate, Co. Westmeath ",95000,148000,-53000,-35.81,316,Westmeath,Leinster
4206,2022-02-04," 10 Preston Gate, Athy, Kildare ",175000,180000,-5000,-2.78,316,Kildare,Leinster
4207,2022-02-04," 1 Cherrington, Ballintemple, Cork ",320000,365000,-45000,-12.33,316,Cork,Munster
4208,2022-02-04," 43 Sli Burca, Ballymoneen Road, Knocknacarra, Galway ",280000,305000,-25000,-8.2,316,Galway,Connaught
4209,2022-02-04," 45 Monacnappa Estate, Blarney, Cork ",340000,375000,-35000,-9.33,317,Cork,Munster
4210,2022-02-04," Apt 30 Packenham House, South City Centre - D8, Dublin 8 ",230000,240000,-10000,-4.17,317,Dublin 8,Leinster
4211,2022-02-04," 19 Grattan Park, Mount Bellew, Galway ",275000,270000,5000,1.85,317,Galway,Connaught
4212,2022-02-03," 20 The Belfry,Cock Hill,Cavan,H12 V6W2 ",130000,100000,30000,30.0,317,Cavan,Ulster
4213,2022-02-03," 11A Neville Street, New Ross, Wexford ",100000,95000,5000,5.26,317,Wexford,Leinster
4214,2022-02-03," Cork Road, Durrow, Laois ",165000,145000,20000,13.79,317,Laois,Leinster
4215,2022-02-03," No 1 Coffeys Row, Kenmare, Kerry ",180000,160000,20000,12.5,317,Kerry,Munster
4216,2022-02-03," 4 The Cloone Road, Mohill, Leitrim ",65000,75000,-10000,-13.33,317,Leitrim,Connaught
4217,2022-02-03," 3 Moy Heights, Ballina, Mayo ",160000,149000,11000,7.38,317,Mayo,Connaught
4219,2022-02-03," 44 Killiney Hill Park, Killiney, Dublin ",415000,465000,-50000,-10.75,317,Dublin,Leinster
4220,2022-02-03," 3 Valley of the Diamonds, Pier Rd, Enniscrone, Sligo ",125000,135000,-10000,-7.41,317,Sligo,Connaught
4221,2022-02-03," 369 Meadowbrook, Kilcoole, Wicklow ",435000,445000,-10000,-2.25,318,Wicklow,Leinster
4222,2022-02-02," Corrib Wave Guest House & Angling Centre, Oughterard, Galway ",750000,850000,-100000,-11.76,318,Galway,Connaught
4223,2022-02-02," 10 Castle Oaks, Kiltegan, Wicklow ",235000,250000,-15000,-6.0,318,Wicklow,Leinster
4225,2022-02-02," 23 Bru na hAbhainn, Navan, Co. Meath , Navan, Meath ",270000,265000,5000,1.89,318,Meath,Leinster
4226,2022-02-02," 19 Rushbrook Way, Templeogue, Dublin 6W ",516000,495000,21000,4.24,318,Dublin,Leinster
4227,2022-02-01," 44 Boroimhe Beech, Swords, Dublin North County, Dublin ",260000,270000,-10000,-3.7,318,Dublin,Leinster
4228,2022-02-01," 101 Forest Park, Drogheda, Louth ",250000,235000,15000,6.38,319,Louth,Leinster
4229,2022-02-01," 8 Dodder Park Road, Rathfarnham, Dublin 14, D14 W968 ",695000,660000,35000,5.3,319,Dublin 14,Leinster
4230,2022-02-01," Peppardscastle (Site D),Ballygarrett,Gorey,Co Wexford ",79000,75000,4000,5.33,319,Wexford,Leinster
4232,2022-02-01," 50 Grand Priory, Headfort Road, Kells, Meath ",335000,350000,-15000,-4.29,319,Meath,Leinster
4233,2022-02-01," 15 Granary Wharf, Glenbrook, Cork ",275000,285000,-10000,-3.51,319,Cork,Munster
4234,2022-02-01," No.46 Ard Aisling, Charlestown Road, Tubbercurry, Sligo ",170000,165000,5000,3.03,319,Sligo,Connaught
4235,2022-02-01," 45 Clare Street, Dublin Road, City Centre (Limerick), Limerick City ",165000,169950,-4950,-2.91,319,Limerick,Munster
4236,2022-01-31," 45 Westbury Woods,Enniscorthy,Co. Wexford,Y21 V6Y2 ",199000,170000,29000,17.06,319,Wexford,Leinster
4237,2022-01-31," Bohernagrisna,Ballycumber,Co Offaly,R35W308 ",155000,175000,-20000,-11.43,319,Offaly,Leinster
4238,2022-01-31," 48 Glin Road, Coolock, Dublin 5 ",295000,315000,-20000,-6.35,319,Dublin 5,Leinster
4239,2022-01-31," Apt. 3, 5 Upper George's St., Dun Laoghaire, County Dublin ",495000,550000,-55000,-10.0,320,Dublin,Leinster
4241,2022-01-31," Irishtown, Gormanston, Meath ",750000,675000,75000,11.11,320,Meath,Leinster
4242,2022-01-31," Corner House, Garra, Tuam, Galway ",135000,125000,10000,8.0,320,Galway,Connaught
4243,2022-01-31," First Floor Offices, Bedford Place, Howleys Quay, Limerick City, Limerick ",325000,320000,5000,1.56,320,Limerick,Munster
4244,2022-01-31," 181 Sarsfield Road, Dublin 10, Dublin ",385000,295000,90000,30.51,320,Dublin,Leinster
4245,2022-01-31," SITE FOR SALE main street, Piltown, Kilkenny ",400000,1000000,-600000,-60.0,320,Kilkenny,Leinster
4246,2022-01-31," Ballaghcloneen, Tullaroan, Kilkenny ",400000,440000,-40000,-9.09,320,Kilkenny,Leinster
4247,2022-01-31," Galross, Cloghan, Co. Offaly ",35000,45000,-10000,-22.22,320,Offaly,Leinster
4248,2022-01-31," Corradrish, Foxford, Mayo ",250000,235000,15000,6.38,320,Mayo,Connaught
4249,2022-01-31," Ballyganeen, Ballydavid, Kerry ",320000,340000,-20000,-5.88,320,Kerry,Munster
4252,2022-01-28," Mary Street South, Dundalk, Louth ",169000,175000,-6000,-3.43,321,Louth,Leinster
4253,2022-01-28," 1 The Orchard, Moylough, Co. Galway ",185000,175000,10000,5.71,321,Galway,Connaught
4254,2022-01-28," 20 Lough View Terrace, Glasheen Road, The Lough, Cork City ",190000,195000,-5000,-2.56,321,Cork,Munster
4255,2022-01-28," Gandon Court, Fairgreen, Portlaoise, Laois ",168500,157500,11000,6.98,321,Laois,Leinster
4257,2022-01-28," Duplex Apartment 11 Whitethorns, Briarfield, Castletroy, Limerick ",205000,190000,15000,7.89,321,Limerick,Munster
4258,2022-01-28," Carrownaclough North, Newtown, Tipperary ",65000,69950,-4950,-7.08,321,Tipperary,Munster
4260,2022-01-28," 109 Saran Wood, Bray, Wicklow ",465000,425000,40000,9.41,321,Wicklow,Leinster
4261,2022-01-28," 31 Lissanalta Drive, Dooradoyle, Limerick ",299000,315000,-16000,-5.08,321,Limerick,Munster
4262,2022-01-28," Doughiska, Doughiska, Galway ",450000,400000,50000,12.5,321,Galway,Connaught
4263,2022-01-28," 7 Heatherfield, Bailieborough, Cavan ",209000,225000,-16000,-7.11,321,Cavan,Ulster
4264,2022-01-27," 66 Old Kilmainham Village, Kilmainham, Dublin 8 ",330000,295000,35000,11.86,322,Dublin 8,Leinster
4265,2022-01-27," 3 Pairc Na Ri , Athenry, Galway ",420000,410000,10000,2.44,322,Galway,Connaught
4266,2022-01-27," 17 Pairc Na Ri , Athenry, Galway ",440000,425000,15000,3.53,322,Galway,Connaught
4268,2022-01-27," 28 Cortolvin Road, Monaghan Town, Monaghan ",170000,165000,5000,3.03,322,Monaghan,Ulster
4269,2022-01-27," 31 Dun Uisce, Cahir, Tipperary ",176000,170000,6000,3.53,322,Tipperary,Munster
4271,2022-01-27," 30 Ard Mullen, Kenmare, Kerry ",320000,315000,5000,1.59,322,Kerry,Munster
4272,2022-01-27," ""Baile An Fhéir"" Ballynare Cross, Kilcloon, Meath ",145000,150000,-5000,-3.33,322,Meath,Leinster
4273,2022-01-26," 4 Inchicore Terrace South, Inchicore, Dublin 8 ",550000,395000,155000,39.24,322,Dublin 8,Leinster
4274,2022-01-26," Stanhope Street, Ballinakill, Laois ",130000,150000,-20000,-13.33,323,Laois,Leinster
4275,2022-01-26," 24 Carrigmore Green, Saggart, Saggart, County Dublin ",400000,360000,40000,11.11,323,Dublin,Leinster
4276,2022-01-26," 23, Carrigmore Green, Citywest, Dublin 24 ",400000,370000,30000,8.11,323,Dublin 24,Leinster
4277,2022-01-26," 13, Avonbeg Road, Tallaght, Dublin 24 ",300000,270000,30000,11.11,323,Dublin 24,Leinster
4278,2022-01-26," 23, Carrigmore Green, Saggart, Dublin ",400000,370000,30000,8.11,323,Dublin,Leinster
4279,2022-01-26," 24 Carrigmore Green, Saggart, Citywest, Dublin 24 ",400000,360000,40000,11.11,323,Dublin 24,Leinster
4280,2022-01-26," Bayview, Ballisodare, Sligo ",129000,145000,-16000,-11.03,323,Sligo,Connaught
4282,2022-01-26," 18 Sheephill Avenue, Blanchardstown, Dublin 15 ",249950,199950,50000,25.01,323,Dublin 15,Leinster
4283,2022-01-26," 72 Marlborough Rd, Donnybrook, Dublin ",1095000,1050000,45000,4.29,323,Dublin,Leinster
4284,2022-01-25," 2 Station Road, Clonsilla, Dublin 15 ",495000,475000,20000,4.21,324,Dublin 15,Leinster
4285,2022-01-25," Castle Park, Thurles, Tipperary ",259000,265000,-6000,-2.26,324,Tipperary,Munster
4287,2022-01-25," 100 Spencer Street,Castlebar,Co Mayo,F23 KR20 ",260000,295000,-35000,-11.86,324,Mayo,Connaught
4288,2022-01-25," 21 Mill Grove, Delgany, Wicklow ",480000,450000,30000,6.67,324,Wicklow,Leinster
4290,2022-01-25," Trim Road, Ballivor, Meath ",245000,250000,-5000,-2.0,324,Meath,Leinster
4292,2022-01-25," Trim Road, , Ballivor, Meath ",245000,250000,-5000,-2.0,324,Meath,Leinster
4293,2022-01-24," 14 Barr an Bhaile Maulbaun, Passage West, Cork ",250000,240000,10000,4.17,324,Cork,Munster
4294,2022-01-24," Aghacashel, A82, Virginia, Co. Cavan ",285000,264950,20050,7.57,324,Cavan,Ulster
4295,2022-01-24," 15 Seabourne View , Greystones, Wicklow ",340000,335000,5000,1.49,324,Wicklow,Leinster
4296,2022-01-24," Creevy, Carrickmacross, Monaghan ",50000,70000,-20000,-28.57,324,Monaghan,Ulster
4299,2022-01-24," 56 Saint Mary's Road, East Wall, Dublin 3 ",499950,474950,25000,5.26,325,Dublin 3,Leinster
4300,2022-01-24," 18 Glenbeg Point, Ardamine, Wexford ",200000,220000,-20000,-9.09,325,Wexford,Leinster
4301,2022-01-24," Blessington Court, North City Centre, Dublin 7 ",515000,480000,35000,7.29,325,Dublin 7,Leinster
4302,2022-01-24," 8 Thornberry, Abbeyleix, Laois ",185000,170000,15000,8.82,325,Laois,Leinster
4304,2022-01-21," 6 Brooklawn, Ballyfoyle Road, Co. Kilkenny ",450000,475000,-25000,-5.26,325,Kilkenny,Leinster
4305,2022-01-21," 69-72 Mungret Street, City Centre (Limerick), Limerick City ",260000,220000,40000,18.18,326,Limerick,Munster
4306,2022-01-21," Land c. 17 Acres, Kingswood Cross, Naas Road, Dublin 22 ",645000,695000,-50000,-7.19,326,Dublin 22,Leinster
4307,2022-01-21," Fintra Road, Killybegs, Donegal ",375000,315000,60000,19.05,326,Donegal,Ulster
4309,2022-01-20," Apartment 1 Beau Court, Achill Road, Drumcondra, Dublin 9 ",239950,269950,-30000,-11.11,326,Dublin 9,Leinster
4310,2022-01-20," 46 Beverton Green, Dublin North County, Dublin ",450000,400000,50000,12.5,326,Dublin,Leinster
4311,2022-01-20," 39 Fearann Ri, Doughiska, Doughiska, Galway City ",285000,262500,22500,8.57,326,Galway,Connaught
4312,2022-01-20," Main St, Foxford, Foxford, Mayo ",90000,75000,15000,20.0,326,Mayo,Connaught
4313,2022-01-20," Main St, Foxford, Mayo ",90000,75000,15000,20.0,326,Mayo,Connaught
4315,2022-01-20," C. 1.43 Acres Site at Lowertown More, Mountbolus, Tullamore, Offaly ",55000,50000,5000,10.0,326,Offaly,Leinster
4317,2022-01-20," 228 & 230 Templeogue Road, Templeogue, Dublin 6W ",520000,570000,-50000,-8.77,326,Dublin,Leinster
4318,2022-01-20," Lower Ballylynch, Carrick-on-Suir, Tipperary ",125000,155000,-30000,-19.35,326,Tipperary,Munster
4319,2022-01-19," Tullycallick,Glaslough,Co. Monaghan ",550000,500000,50000,10.0,327,Monaghan,Ulster
4320,2022-01-19," 3 Elder Heath Meadow, Kiltipper, D24, Dublin 24, Dublin ",375000,365000,10000,2.74,327,Dublin,Leinster
4321,2022-01-19," 13 Dun Ri, Attyrory, Carrick-on-Shannon, Leitrim ",175000,170000,5000,2.94,327,Leitrim,Connaught
4323,2022-01-19," 53 Joyce House East, Viking Harbour, South City Centre - D8, Dublin 8 ",330000,275000,55000,20.0,327,Dublin 8,Leinster
4324,2022-01-19," Leasehold Interest, No. 3 Park Street, Dundalk, Louth ",50000,80000,-30000,-37.5,327,Louth,Leinster
4325,2022-01-19," 24 Caisleáin na Habhann, Castletroy, Limerick ",215000,220000,-5000,-2.27,327,Limerick,Munster
4326,2022-01-19," 1 Ard Abhainn, Carrignagroghera, Fermoy, Cork ",260000,250000,10000,4.0,327,Cork,Munster
4328,2022-01-19," Ballynoe, Bruree, Limerick ",150000,130000,20000,15.38,327,Limerick,Munster
4329,2022-01-19," Rathpeake, 5 Hazeldene Drive, Ennis Road, Limerick ",320000,330000,-10000,-3.03,327,Limerick,Munster
4330,2022-01-19," 11 Woodside Park, Ballaghaderreen, Roscommon ",100000,90000,10000,11.11,328,Roscommon,Connaught
4331,2022-01-19," 27 Station Grove, Portarlington, Laois ",210000,220000,-10000,-4.55,328,Laois,Leinster
4332,2022-01-18," 44 Sliabh Carran, Ennis Road, Gort, Galway ",185000,195000,-10000,-5.13,328,Galway,Connaught
4333,2022-01-18," Kylemore,Killimor,Ballinasloe,Co. Galway,H53 XT66 ",160000,185000,-25000,-13.51,328,Galway,Connaught
4334,2022-01-18," 40 Portersgate Heights, Clonsilla, Dublin 15 ",385000,375000,10000,2.67,328,Dublin 15,Leinster
4336,2022-01-18," Type F3 - Four Bed Detached,Harbour Heights,Rochestown Road,Cork ",440000,320000,120000,37.5,328,Cork,Munster
4337,2022-01-18," 11 The Glen, Coosan, Athlone East, Westmeath ",214000,220000,-6000,-2.73,328,Westmeath,Leinster
4338,2022-01-18," 12 Alder Grove, Fota Rock, Carrigtwohill, Cork ",275000,265000,10000,3.77,328,Cork,Munster
4340,2022-01-18," 54 Ashbrook, Oranmore, Galway ",380000,360000,20000,5.56,328,Galway,Connaught
4341,2022-01-18," 17 Dun na Ri , Buncrana, Donegal, F93 H003 ",119000,115000,4000,3.48,328,Donegal,Ulster
4342,2022-01-18," 3 Lindisfarne Green, Clondalkin, Dublin 22 ",270000,280000,-10000,-3.57,328,Dublin 22,Leinster
4343,2022-01-18," Creeny Business Park, Belturbet, Cavan ",225000,195000,30000,15.38,328,Cavan,Ulster
4345,2022-01-17," 3 Mornington Court, Mornington, Meath ",279000,285000,-6000,-2.11,329,Meath,Leinster
4346,2022-01-17," 195 Tuskar Rock, Custom House Harbour, IFSC, Dublin 1 ",275000,279950,-4950,-1.77,329,Dublin 1,Leinster
4347,2022-01-17," Council Depot, Toomevara, Nenagh, Co. Tipperary ",49500,39500,10000,25.32,329,Tipperary,Munster
4348,2022-01-17," Cornashamsoge, Drumshanbo, Leitrim ",329000,395000,-66000,-16.71,329,Leitrim,Connaught
4349,2022-01-17," 5 The Pines, French Park, Tyrrelstown, Dublin ",225000,215000,10000,4.65,329,Dublin,Leinster
4350,2022-01-17," 20 ST. COLUMBA'S ROAD LOWER, Drumcondra, Dublin 9 ",645000,595000,50000,8.4,329,Dublin 9,Leinster
4351,2022-01-17," Arranmore House, 104 Lower Drumcondra Road, Drumcondra, Dublin 9 ",1100000,1200000,-100000,-8.33,329,Dublin 9,Leinster
4352,2022-01-16," Derrincullig, Kilgarvan, Kerry ",150000,200000,-50000,-25.0,330,Kerry,Munster
4354,2022-01-14," 12 Cambridge Avenue, Ringsend, Dublin 4 ",450000,440000,10000,2.27,330,Dublin 4,Leinster
4355,2022-01-14," 9 Curragh Woods, Kilanerin, Wexford ",695000,650000,45000,6.92,330,Wexford,Leinster
4356,2022-01-14," Carrownrod, Easkey, Sligo ",350000,250000,100000,40.0,330,Sligo,Connaught
4357,2022-01-14," Hill of Heather, Knockfree, Cloghans , Ballina, Mayo ",175000,165000,10000,6.06,330,Mayo,Connaught
4358,2022-01-13," Athdara,Stirling Bridge,Clonee,County Meath,D15E959 ",1500000,1795000,-295000,-16.43,330,Meath,Leinster
4359,2022-01-13," 3 The Woodlands,Mount Falcon,Ballina,Co Mayo,F26 V6R9 ",315000,310000,5000,1.61,330,Mayo,Connaught
4360,2022-01-13," The Beeches, Clogherhead, Louth ",305000,300000,5000,1.67,330,Louth,Leinster
4361,2022-01-13," 2 Priest Lane, Park View, Carrick-on-Shannon, Leitrim ",130000,125000,5000,4.0,330,Leitrim,Connaught
4362,2022-01-13," Harbour Lights, 4 Knocklaun St. Lukes, City Centre Nth, Cork City ",295000,275000,20000,7.27,330,Cork,Munster
4363,2022-01-13," 5 Woodville, Loughrea, Co. Galway, Loughrea, Galway ",265000,285000,-20000,-7.02,330,Galway,Connaught
4364,2022-01-13," 23 Village Court, Butterfield Avenue,, Rathfarnham, Dublin 14 ",295000,279950,15050,5.38,330,Dublin 14,Leinster
4365,2022-01-13," 22 The Avenue, Clonattin Village, Gorey, Wexford ",210000,220000,-10000,-4.55,330,Wexford,Leinster
4366,2022-01-13," Westland, Long Island, Schull,   West Cork ",245000,295000,-50000,-16.95,331,Cork,Munster
4367,2022-01-12," 6 Manor Hall, Mount Brown, Kilmainham, Dublin 8 ",259950,279000,-19050,-6.83,331,Dublin 8,Leinster
4368,2022-01-12," 11 CHESTNUT CRESCENT BRIDGEMOUNT, Carrigaline, Cork ",290000,295000,-5000,-1.69,331,Cork,Munster
4369,2022-01-12," 11 Cois Caladh, George's Quay, Waterford City, Waterford ",119000,117500,1500,1.28,331,Waterford,Munster
4370,2022-01-12," 14 Caireal Mor, Headford Road, Galway City ",295000,315000,-20000,-6.35,331,Galway,Connaught
4371,2022-01-12," 1 The Dales, Maryborough Woods, Douglas, Cork ",375000,355000,20000,5.63,331,Cork,Munster
4372,2022-01-12," Clifford House, Ballinlough Road, Ballinlough, Cork City ",790000,825000,-35000,-4.24,331,Cork,Munster
4374,2022-01-12," St Síle, Ballinvounig, Dingle, Kerry ",315000,345000,-30000,-8.7,332,Kerry,Munster
4375,2022-01-12," Main Street, Glin, Limerick ",170000,149000,21000,14.09,332,Limerick,Munster
4376,2022-01-12," Offaly Street, Athy, Kildare ",120000,130000,-10000,-7.69,332,Kildare,Leinster
4377,2022-01-11," 33 The Brosna, N91, Mullingar, Co. Westmeath ",159950,149950,10000,6.67,332,Westmeath,Leinster
4378,2022-01-11," 1 Fairview Close, Richmond Avenue, Fairview, Dublin ",245000,240000,5000,2.08,332,Dublin,Leinster
4380,2022-01-11," 15 Tullybrook Lane, Slane Road, Drogheda, Louth ",230000,200000,30000,15.0,332,Louth,Leinster
4381,2022-01-11," 55 Park Boulevard, Tyrrelstown, Dublin 15 ",174950,199950,-25000,-12.5,332,Dublin 15,Leinster
4382,2022-01-11," 122 Castledawson, Maynooth, Co. Kildare. , Maynooth, Kildare ",499950,525000,-25050,-4.77,332,Kildare,Leinster
4383,2022-01-11," 100 Ardglass, Baltinglass, Wicklow ",259950,270000,-10050,-3.72,333,Wicklow,Leinster
4384,2022-01-11," 13 Butterfield Avenue, Old Cork Road, Limerick City, Limerick ",190000,180000,10000,5.56,333,Limerick,Munster
4385,2022-01-11," Old School House, Killashandra, Cavan ",280000,295000,-15000,-5.08,333,Cavan,Ulster
4386,2022-01-10," 37 Balfe Avenue, Walkinstown,   Dublin 12 ",450000,398000,52000,13.07,333,Dublin 12,Leinster
4387,2022-01-10," Four Bedroom Semi-Detached,Vicars Glebe,Coachford,Co. Cork ",360000,300000,60000,20.0,333,Cork,Munster
4388,2022-01-10," Three Bedroom Bungalow,Vicars Glebe,Coachford,Co. Cork ",255000,225000,30000,13.33,333,Cork,Munster
4390,2022-01-10," 48 Knockcarrick, Castleblayney, Monaghan ",215000,210000,5000,2.38,333,Monaghan,Ulster
4391,2022-01-10," No 5 The Break, Colla Road, Schull,   West Cork ",450000,495000,-45000,-9.09,333,Cork,Munster
4392,2022-01-10," Farnane, Murroe, Co. Limerick ",65000,90000,-25000,-27.78,333,Limerick,Munster
4393,2022-01-10," Glann Road, Oughterard, Co. Galway ",260000,270000,-10000,-3.7,333,Galway,Connaught
4395,2022-01-10," 2 Herbert Avenue, Merrion road, Ballsbridge, Dublin 4, D04A2A0 ",845000,785000,60000,7.64,333,Dublin 4,Leinster
4396,2022-01-10," 15 Dunraven Downs, Blackrock Road, Blackrock, Cork City ",267500,275000,-7500,-2.73,334,Cork,Munster
4397,2022-01-10," Ballintue, Ballynacarrigy, Westmeath ",650000,795000,-145000,-18.24,334,Westmeath,Leinster
4399,2022-01-10," 117 Willow Heights, Clonmel, Co. Tipperary ",185000,175000,10000,5.71,334,Tipperary,Munster
4401,2022-01-10," Silverwood, Enniskerry, Wicklow ",715000,750000,-35000,-4.67,334,Wicklow,Leinster
4402,2022-01-10," 27 Carrigwood, Firhouse, Dublin 24 ",425000,395000,30000,7.59,334,Dublin 24,Leinster
4403,2022-01-10," 19 Foxborough Rise, Lucan, Dublin ",305000,290000,15000,5.17,334,Dublin,Leinster
4404,2022-01-10," Gortdrum, Donohill, Tipperary ",175000,165000,10000,6.06,334,Tipperary,Munster
4405,2022-01-10," 15 Dyke Parade, Cork City ",665000,655000,10000,1.53,334,Cork,Munster
4406,2022-01-10," 32 Belarmine Lawns, Stepaside, Dublin 18 ",595000,585000,10000,1.71,334,Dublin 18,Leinster
4407,2022-01-09," 70 Pearse Street, South City Centre, Dublin 2 ",690000,750000,-60000,-8.0,334,Dublin 2,Leinster
4408,2022-01-07," Lands, At Swiss Cottage, Bray Road, Enniskerry, Co. Wicklow ",320000,315000,5000,1.59,334,Wicklow,Leinster
4409,2022-01-07," Strandfield Manor, Spawell Road, Wexford, Co. Wexford ",290000,275000,15000,5.45,334,Wexford,Leinster
4410,2022-01-07," Ballybeg Kincon, Ballina, Mayo ",85000,70000,15000,21.43,335,Mayo,Connaught
4411,2022-01-07," 18a Newcomen Avenue, North Strand, Dublin 3 ",280000,290000,-10000,-3.45,335,Dublin 3,Leinster
4412,2022-01-07," Cornacassa, Monaghan Town, Monaghan ",120000,80000,40000,50.0,335,Monaghan,Ulster
4413,2022-01-07," 376 Nutgrove Avenue, Churchtown, Dublin 14 ",575000,525000,50000,9.52,335,Dublin 14,Leinster
4414,2022-01-07," Curtistown, Kilmessan, Meath ",55000,60000,-5000,-8.33,335,Meath,Leinster
4415,2022-01-07," 50 Clonkeen Drive, Foxrock, Dublin ",725000,695000,30000,4.32,335,Dublin,Leinster
4417,2022-01-07," Bayview, Carrigart, Donegal ",325000,295000,30000,10.17,335,Donegal,Ulster
4418,2022-01-07," An Sean Mhuileann, Tralee, Kerry ",110000,80000,30000,37.5,335,Kerry,Munster
4419,2022-01-06," Usk, Colbinstown, Kilcullen, Kildare ",450000,420000,30000,7.14,335,Kildare,Leinster
4420,2022-01-06," 22 Grattan Hill , St. Luke's, Cork City, Cork ",495000,490000,5000,1.02,335,Cork,Munster
4421,2022-01-06," 74 Carraigroe, Mitchelstown, Cork ",135000,145000,-10000,-6.9,336,Cork,Munster
4422,2022-01-05," Creemully & Aghagad Beg, Castlecoote Village, Co. Roscommon ",40000,45000,-5000,-11.11,336,Roscommon,Connaught
4423,2022-01-05," 6-11 Villla Park Springs, Navan Road, Dublin 7 ",1250000,1450000,-200000,-13.79,336,Dublin 7,Leinster
4424,2022-01-05," Main Street,Charleville,Co Cork,P56 T970 ",225000,250000,-25000,-10.0,336,Cork,Munster
4426,2022-01-05," 1 Acre Site,Kilkea,Ballyvass,Co. Kildare ",95000,100000,-5000,-5.0,336,Kildare,Leinster
4427,2022-01-05," Thornfield, Radestown Lane, Radestown, Kilkenny, Kilkenny ",635000,585000,50000,8.55,336,Kilkenny,Leinster
4430,2022-01-04," Lissivigeen, Killarney, Kerry ",360000,430000,-70000,-16.28,336,Kerry,Munster
4431,2022-01-04," Saint Jude's, Bluebell Avenue, Bluebell, Dublin 12 ",340000,250000,90000,36.0,336,Dublin 12,Leinster
4432,2022-01-04," 4 Fastnet Court, Marina Village, Arklow, Wicklow ",225000,229000,-4000,-1.75,336,Wicklow,Leinster
4433,2022-01-04," 23 Hollybank Crescent, Clongowen,  Waterford Road, Kilkenny, Kilkenny ",310000,325000,-15000,-4.62,336,Kilkenny,Leinster
4434,2022-01-04," Ros Mor, Rathealy Road, Fermoy, Cork ",295000,320000,-25000,-7.81,336,Cork,Munster
4435,2022-01-04," 5b Ballalease West, Donabate,   County Dublin ",630000,595000,35000,5.88,336,Dublin,Leinster
4436,2022-01-04," Mitchelstown Business Park, Dublin Road, Mitchelstown, Cork ",400000,270000,130000,48.15,337,Cork,Munster
4438,2022-01-04," 49 Knocklyon Gate, Knocklyon, Dublin 16 ",395000,410000,-15000,-3.66,337,Dublin 16,Leinster
4439,2022-01-04," 15 Findlater Street, Stoneybatter, Dublin 7 ",285000,295000,-10000,-3.39,337,Dublin 7,Leinster
4440,2021-12-24," 164 Charlesland Court, Greystones, Co. Wicklow ",370000,375000,-5000,-1.33,337,Wicklow,Leinster
4441,2021-12-23," 53 Brackrainey Manor, Longwood, Meath ",265000,245000,20000,8.16,337,Meath,Leinster
4442,2021-12-23," William's Grove, Ardclough, Straffan, Kildare ",440000,385000,55000,14.29,337,Kildare,Leinster
4443,2021-12-23," Chapel Road, Cliffoney, Sligo ",65000,85000,-20000,-23.53,337,Sligo,Connaught
4444,2021-12-23," 7 CLONTURK AVENUE, Drumcondra, Dublin 9 ",300000,325000,-25000,-7.69,337,Dublin 9,Leinster
4446,2021-12-22," 28 Clover Hill Road, Ballyfermot, Dublin 10 ",249000,235000,14000,5.96,338,Dublin 10,Leinster
4447,2021-12-22," 8 North William Street, North City Centre,   Dublin 1 ",345000,295000,50000,16.95,338,Dublin 1,Leinster
4448,2021-12-22," The Gables, Nova Court, Ballea Road,, Carrigaline, Cork ",470000,480000,-10000,-2.08,338,Cork,Munster
4449,2021-12-22," 25 The Sweepstakes, Ballsbridge, Dublin 4 ",460000,495000,-35000,-7.07,338,Dublin 4,Leinster
4451,2021-12-21," Apt 12 Stanley Court, Prussia Street, Stoneybatter, Dublin 7 ",280000,285000,-5000,-1.75,338,Dublin 7,Leinster
4452,2021-12-21," 11 Halliday Square, Stoneybatter, Dublin 7 ",430000,420000,10000,2.38,338,Dublin 7,Leinster
4453,2021-12-21," 2 High Street, Goresbridge, Co Kilkenny, Goresbridge, Kilkenny ",185000,180000,5000,2.78,338,Kilkenny,Leinster
4454,2021-12-21," 10 Griffeen Glen Court, Lucan, Co. Dublin ",380000,360000,20000,5.56,338,Dublin,Leinster
4455,2021-12-21," 16 Healy Street, North Circular Road, Dublin 1 ",250000,225000,25000,11.11,338,Dublin 1,Leinster
4456,2021-12-20," 21 Clochog, Oranmore, Galway, H91T8W9 ",320000,330000,-10000,-3.03,339,Galway,Connaught
4458,2021-12-20," 32 Main Street,Charleville,Co Cork,P56 A026 ",170000,250000,-80000,-32.0,339,Cork,Munster
4459,2021-12-20," Springvale House, Springvale, Ballinrobe, Mayo ",590000,600000,-10000,-1.67,339,Mayo,Connaught
4460,2021-12-20," 11 Railway Street, Navan, Meath ",195000,175000,20000,11.43,339,Meath,Leinster
4461,2021-12-20," Apartment 39 The Eden, Prospect Hill, Finglas, Dublin 11 ",224950,249950,-25000,-10.0,339,Dublin 11,Leinster
4462,2021-12-20," 'Copper Pines' Ballycummisk South, Ballydehob, West Cork ",750000,700000,50000,7.14,339,Cork,Munster
4463,2021-12-20," 312 Monks Bridge, Maryborough Village, Portlaoise, Laois ",245000,189000,56000,29.63,339,Laois,Leinster
4464,2021-12-20," Knocknamouragh, Midleton, Cork ",320000,280000,40000,14.29,339,Cork,Munster
4465,2021-12-18," BEECH MOUNT HOUSE, BALLYHANNOBERRY, Cahir, Tipperary ",425000,395000,30000,7.59,339,Tipperary,Munster
4466,2021-12-17," 17 Woodlands Maynooth Co Kildare, Maynooth, Kildare ",589000,550000,39000,7.09,340,Kildare,Leinster
4467,2021-12-17," 62 Farney Street, Carrickmacross, Monaghan ",165000,170000,-5000,-2.94,340,Monaghan,Ulster
4468,2021-12-17," Apt 7 Bowers Lane Main St, Ballinrobe, Mayo ",90000,85000,5000,5.88,340,Mayo,Connaught
4471,2021-12-16," 'Ceiliur', Ballytarsna, Ballycullane, Wexford ",375000,395000,-20000,-5.06,340,Wexford,Leinster
4473,2021-12-16," Tully Glenroe, Kilmallock, Limerick ",235000,225000,10000,4.44,340,Limerick,Munster
4474,2021-12-16," 4D Roseville Court, Newbridge, Kildare ",175000,190000,-15000,-7.89,340,Kildare,Leinster
4475,2021-12-16," Joanstown, Carrick-beg, Waterford ",280000,300000,-20000,-6.67,340,Waterford,Munster
4476,2021-12-16," 16 Rockview Terrace, Arklow, Wicklow ",215000,225000,-10000,-4.44,340,Wicklow,Leinster
4477,2021-12-16," Cortonrue, Tuam, Galway ",150000,170000,-20000,-11.76,340,Galway,Connaught
4478,2021-12-15," 45 Berry's Court, Inchicore, Dublin 8 ",240000,195000,45000,23.08,341,Dublin 8,Leinster
4479,2021-12-15," 24 WhiteThorn  Road, Artane, Dublin ",379950,399999,-20049,-5.01,341,Dublin,Leinster
4480,2021-12-15," Drumharsna South, Ardrahan, Co. Galway ",45000,55000,-10000,-18.18,341,Galway,Connaught
4482,2021-12-15," 16 Ounavarra Estate, Ballycanew, Wexford ",180000,195000,-15000,-7.69,341,Wexford,Leinster
4483,2021-12-15," 1 Castleross Retirement Village, Carrickmacross, Monaghan ",170000,180000,-10000,-5.56,341,Monaghan,Ulster
4486,2021-12-14," 1 Carraig Ard, Crobally Upper, Tramore, Waterford ",270000,265000,5000,1.89,341,Waterford,Munster
4488,2021-12-14," 11 Yellow Meadows Vale, Clondalkin, Dublin 22 ",350000,275000,75000,27.27,341,Dublin 22,Leinster
4489,2021-12-14," 2194 Highfield Estate, Newbridge, Kildare ",180000,195000,-15000,-7.69,341,Kildare,Leinster
4490,2021-12-14," Rathanny, Kill, Waterford ",325000,349000,-24000,-6.88,341,Waterford,Munster
4491,2021-12-14," Blackhall, Termonfeckin, Drogheda, Louth ",690000,675000,15000,2.22,341,Louth,Leinster
4492,2021-12-14," Bawnleigh, Ballinhassig, Cork ",70000,82500,-12500,-15.15,342,Cork,Munster
4493,2021-12-13," 64 Shannon Park, Edgeworthstown, Longford ",155000,149500,5500,3.68,342,Longford,Leinster
4494,2021-12-13," Shannonside Savouries, Clooncolry, Dromod, Leitrim ",100000,150000,-50000,-33.33,342,Leitrim,Connaught
4495,2021-12-13," 8 Talbot Place, Tramore, Co.Waterford., Tramore, Waterford ",455000,475000,-20000,-4.21,342,Waterford,Munster
4496,2021-12-13," Killaghy Street, Mullinahone, Co. Tipperary ",85000,120000,-35000,-29.17,342,Tipperary,Munster
4497,2021-12-13," Englishtown, Kiltormer, Galway ",395000,425000,-30000,-7.06,342,Galway,Connaught
4498,2021-12-13," 4b Rainsford Avenue, South City Centre - D8, Dublin 8 ",265000,225000,40000,17.78,342,Dublin 8,Leinster
4499,2021-12-13," Farra, Bunbrosna, Mullingar, Westmeath ",180000,250000,-70000,-28.0,342,Westmeath,Leinster
4500,2021-12-13," 23 Abhann Dubh, Portarlington, Laois ",220000,210000,10000,4.76,342,Laois,Leinster
4501,2021-12-13," 4 Kilmainham Orchard, Kilmainham, Dublin 8 ",450000,395000,55000,13.92,342,Dublin 8,Leinster
4502,2021-12-13," Granite's Drum Lacken, Blessington, Wicklow ",738000,729000,9000,1.23,342,Wicklow,Leinster
4504,2021-12-11," 66 Lissadel Drive, Drimnagh, Dublin 12 ",260000,275000,-15000,-5.45,342,Dublin 12,Leinster
4505,2021-12-10," Annagh Lawn,Blennerville,Tralee,Co. Kerry,V92 X2HV ",240000,235000,5000,2.13,342,Kerry,Munster
4507,2021-12-10," 4 Applewood Avenue, Swords, County Dublin ",250000,230000,20000,8.7,343,Dublin,Leinster
4509,2021-12-10," Bert House Stud on c. 58 Acres, Athy, Kildare ",1350000,1300000,50000,3.85,343,Kildare,Leinster
4510,2021-12-10," 2 Seafield Close, Clontarf, Dublin 3 D03 NF24 ",595000,590000,5000,0.85,343,Dublin,Leinster
4511,2021-12-09," 32 Thorndale Close, Kingscourt, Cavan ",205000,225000,-20000,-8.89,343,Cavan,Ulster
4512,2021-12-09," 4 Merchants Place, Dunlavin, Wicklow ",224950,229950,-5000,-2.17,343,Wicklow,Leinster
4513,2021-12-09," 33 Oulsters Lane, Drogheda, Louth ",130000,125000,5000,4.0,343,Louth,Leinster
4514,2021-12-09," 19 The Square, Cnoc Na Greine, Kilcullen, Kildare ",279950,265000,14950,5.64,343,Kildare,Leinster
4515,2021-12-09," 76 Cois na hAbhainn, Ballygaddy Road, Tuam, Galway ",175000,195000,-20000,-10.26,343,Galway,Connaught
4516,2021-12-09," Clash, Abbeyfeale, Limerick ",180000,195000,-15000,-7.69,343,Limerick,Munster
4518,2021-12-09," Newpark, Sixmilebridge, Clare ",395000,420000,-25000,-5.95,344,Clare,Munster
4519,2021-12-09," Site at Moneygourney, Douglas, Cork ",450000,495000,-45000,-9.09,344,Cork,Munster
4520,2021-12-08," 2 Sunnyside,Rathcormac,Co Cork,P61XK22 ",160000,180000,-20000,-11.11,344,Cork,Munster
4521,2021-12-08," Tara House, Scarletstown, Newbridge, Kildare ",375000,395000,-20000,-5.06,344,Kildare,Leinster
4522,2021-12-08," 15 Brighton Avenue, Clontarf, Dublin 3 ",430000,450000,-20000,-4.44,344,Dublin 3,Leinster
4524,2021-12-08," Killadoon, Louisburgh, Mayo ",375000,320000,55000,17.19,344,Mayo,Connaught
4525,2021-12-07," 3 Brandon Park, New Ross, Wexford ",260000,275000,-15000,-5.45,344,Wexford,Leinster
4526,2021-12-07," Newross, Newport, Co. Tipperary ",140000,160000,-20000,-12.5,344,Tipperary,Munster
4527,2021-12-07," Knockavallig, Duagh, Kerry ",130000,110000,20000,18.18,345,Kerry,Munster
4528,2021-12-07," 29 Finnstown Hall, Lucan, Co. Dublin ",250000,270000,-20000,-7.41,345,Dublin,Leinster
4529,2021-12-07," Cullohill, Durrow, Laois ",180000,150000,30000,20.0,345,Laois,Leinster
4530,2021-12-07," Apt 25, 61 Cork Street, South City Centre - D8, Dublin 8 ",280000,290000,-10000,-3.45,345,Dublin 8,Leinster
4531,2021-12-06," 2 Le Vere Terrace, Harold's Cross, Dublin 6W ",270000,245000,25000,10.2,345,Dublin,Leinster
4532,2021-12-06," 46 Mount Assumpta, Ballina, Mayo ",80000,75000,5000,6.67,345,Mayo,Connaught
4533,2021-12-06," 198, Block 4 Parklands, Northwood, Santry, Dublin 9 ",265000,269950,-4950,-1.83,345,Dublin 9,Leinster
4534,2021-12-06," Garrymore, Ballinasloe, Galway, H53 AD66 ",165000,190000,-25000,-13.16,345,Galway,Connaught
4535,2021-12-06," Geehy North, Kinvara, Galway ",195000,225000,-30000,-13.33,345,Galway,Connaught
4536,2021-12-06," 17 Shannon Park, Edgeworthstown, Longford ",195000,179950,15050,8.36,345,Longford,Leinster
4538,2021-12-03," 1 Ocean Point, Courtown, Wexford ",230000,210000,20000,9.52,346,Wexford,Leinster
4539,2021-12-03,"  5 Avenue Demesne Newmarket, Co. Cork, Newmarket, Cork ",169000,170000,-1000,-0.59,346,Cork,Munster
4541,2021-12-03," 25 Moyvale Green, Sligo Road, Ballina, Mayo ",180000,150000,30000,20.0,346,Mayo,Connaught
4543,2021-12-02," 44 & 46 & 48 Connaught St,Athlone,Co. Westmeath ",265000,195000,70000,35.9,346,Westmeath,Leinster
4546,2021-12-02," 80 Herbert Park, Bray, Co. Wicklow ",375000,385000,-10000,-2.6,346,Wicklow,Leinster
4547,2021-12-02," Block 7, Park West Business Park, Park West, Dublin 12 ",2700000,3000000,-300000,-10.0,346,Dublin 12,Leinster
4548,2021-12-02," Cappataggle, Ballinasloe, Galway ",395000,475000,-80000,-16.84,346,Galway,Connaught
4551,2021-12-02," 9 St Aubyns Court, Shanganagh Road, Killiney, Dublin, A96DT92 ",325000,335000,-10000,-2.99,346,Dublin,Leinster
4552,2021-12-01," Letterneevoge, Crossmolina, Co. Mayo ",50000,75000,-25000,-33.33,347,Mayo,Connaught
4555,2021-12-01," 25 Norseman Court, Manor Street, Stoneybatter, Dublin, D07 F208 ",250000,260000,-10000,-3.85,347,Dublin,Leinster
4556,2021-12-01," 89 Fernleigh Drive, Carpenterstown, Dublin 15 ",220000,230000,-10000,-4.35,347,Dublin 15,Leinster
4557,2021-12-01," Chapel Street, Tullamore, Offaly ",160000,150000,10000,6.67,347,Offaly,Leinster
4558,2021-12-01," 2 Pebble Lawn, Pebble Beach, Tramore, Waterford ",175000,160000,15000,9.38,347,Waterford,Munster
4559,2021-12-01," 14 Ruby Hall Rochestown Avenue, Dun Laoghaire, Dublin ",700000,695000,5000,0.72,347,Dublin,Leinster
4560,2021-12-01," 42 Mary Street, Drogheda, Louth ",190000,200000,-10000,-5.0,347,Louth,Leinster
4561,2021-12-01," 6 Upper Cross Road, Rialto, Dublin 8 ",460000,395000,65000,16.46,347,Dublin 8,Leinster
4562,2021-12-01," 52 Beaumont Court, Beaumont Wood, Beaumont, Dublin 9 ",250000,240000,10000,4.17,347,Dublin 9,Leinster
4564,2021-12-01," 41 Orlagh Wood, Scholarstown Road, Knocklyon, Dublin ",595000,635000,-40000,-6.3,347,Dublin,Leinster
4565,2021-12-01," 26 Westbrook Close , Balbriggan, County Dublin ",310000,315000,-5000,-1.59,347,Dublin,Leinster
4567,2021-11-30," Nenagh, Ballymackey, Tipperary ",60000,55000,5000,9.09,348,Tipperary,Munster
4568,2021-11-30," 18 Donn Or, Browneshill, Co. Carlow ",400000,390000,10000,2.56,348,Carlow,Leinster
4569,2021-11-30," Caltra House, Kildwan, Bunmahon, Co. Waterford ",450000,490000,-40000,-8.16,348,Waterford,Munster
4570,2021-11-30," 12 Raithin Eoighan, Mullingar, Westmeath ",110000,130000,-20000,-15.38,348,Westmeath,Leinster
4575,2021-11-29," Laragh More, Ballyglunin, Tuam, Galway ",20000,30000,-10000,-33.33,348,Galway,Connaught
4577,2021-11-29," 66 Esker Fields, Ballinasloe, Galway ",160000,185000,-25000,-13.51,348,Galway,Connaught
4578,2021-11-29," 134 James Street, South City Centre - D8, Dublin 8 ",750000,1200000,-450000,-37.5,348,Dublin 8,Leinster
4581,2021-11-29," 11 DeSelby Drive, Tallaght,   Dublin 24 ",270000,265000,5000,1.89,349,Dublin 24,Leinster
4582,2021-11-29," Apartment 28, Landys Court, Balbriggan, Co. Dublin, Balbriggan, Dublin ",190000,175000,15000,8.57,349,Dublin,Leinster
4583,2021-11-29," 1 Waveney House, Howth, Dublin ",300000,320000,-20000,-6.25,349,Dublin,Leinster
4584,2021-11-29,"  Apt 26, The Schooner, Alverno Clontarf, Co. Dublin, Clontarf, Dublin 3 ",299000,300000,-1000,-0.33,349,Dublin 3,Leinster
4585,2021-11-27," 31 Cross Avenue, Dun Laoghaire, County Dublin ",475000,465000,10000,2.15,349,Dublin,Leinster
4588,2021-11-26," 1 Rollins Villas, Sallynoggin, County Dublin ",395000,325000,70000,21.54,349,Dublin,Leinster
4589,2021-11-26," 6 Westbourne View, Clondalkin, Dublin 22 ",249950,265000,-15050,-5.68,349,Dublin 22,Leinster
4590,2021-11-26," 3 Seabank Terrace, Sea Road,, Arklow, Wicklow ",225000,295000,-70000,-23.73,349,Wicklow,Leinster
